<<<<<<< HEAD
Delireceğim kafayı yiyeceğim sus beynim sus	kızgın
Final haftamda çok agresifim uçan kusla bile kavga ediyorum	kızgın
Ne demek yürürken mesaj atamıyorum mal mısın	kızgın
Evet sizi bırakıp Mobile legends oynayıp küfür edeceğim ama geri gelicem	kızgın
Eğer sprite içersen seninde paran gidecek mal mısın ya	kızgın
Kaptana kızgınım, insan bizi de çağırır	kızgın
Ağız şapırdatmak kadar sinir bozucu birşey yoktur herhalde.	kızgın
Sevgilimi çok özledim bana ters yapan olursa başının üstünde yeri var agresifim kompleksliyim şu an	kızgın
hay sikeyim seni gibi yorumcuyu bir de buna para veriyorlar ya sinir oluyorum lan 	kızgın
Hakaret ediyormuşum sinirinden geçilmiyor. Sen bana ne yaptın farkında mısın!	kızgın
İstediğin insanla mutlu ol, o yüzün hep gülsün ama lütfen artık defolup git şu aklımdan	kızgın
Nasıl domuz eti yersin sen ya sinirden küplere bindim uyuyamıyorum ! 	kızgın
Bana kısa cevap vermeyin çok sinir oluyorum ya	kızgın
Ben takip atıyorum siz GT atmıyorsunuz ve ben size sövüyorum	kızgın
Toplumun her kesiminden insana öfkeliyim	kızgın
Site toplantısına oğlumu yolladım sinir küpü olmuş bir şekilde geldi 	kızgın
Elektrikler gitti sıçıcam böyle işe resmen izlemiyim diye amk kudurdum sinirden 	kızgın
Kasım ayında sivrisinek mi olur ya kafayı yiyeceğim artık	kızgın
kısa kısa cevaplar vericeksen niye yazıyorsun gerizekalı	kızgın
çok agresif hissediyorum şu an yani bilmiyorum belki de çişim olduğundandır	kızgın
Çok fena iftira atıldı üstüme şu an çok sinirliyim	kızgın
Ben bu kızı unutalı sene geçti neden gördüm ki yine? Sinirlendim	kızgın
Sol şeritte 90 lik yolda 50 sürüyor gerizekalı. Allah'ım sakin olamıyorum böylelerini görünce	kızgın
Birşey anlatırken ben demiştim ama diyip duranlara sinir oluyorum. Ama aynı şey karşı tarafa olsa hiç çekinmem söylerim.	kızgın
2-3 ay yazmıyor. Sonra geliyor en şerefsiz haliyle hiçbir şey olmamış gibi kafa karıştırıyor. Ya bir defol git.	kızgın
Nefretimiz elektriğe dönüştürülebilseydi bütün dünyayı aydınlatmaya yeterdi 	kızgın
Şimdi burda bi küfür edeceğim 150 kişi takipten çıkacak o kadar doluyum	kızgın
Allah boy veriyor tip veriyor ama zekadan kısıyor işte nabalım gerizekalı	kızgın
Saatlerdir yataktan kalkıp duş alayım diye uğraşıyorum, kalkamıyorum delireceğim	kızgın
Kramp senden nefret ediyorum	kızgın
Öyle sinirliyim ki araç sürmeme izin vermiyorlar. Anahtar saklamak nedir?!	kızgın
Sabah sabah aklımda ne işin var ya bir defol git...	kızgın
Seni ilk bakışta gerizekalı felan sandım cidden gerizekalıymışsın	kızgın
Yeter artık bir karadenizliyle evlendirip dağlara salın beni çıldıracağım yeter	kızgın
Elit bir semtte oturmasam sokağa çıkıp bağıra bağıra küfür edeceğim sinirim bedenime sığmıyor..	kızgın
Germeyin oğlum beni sinirliyim agresifim bak	kızgın
artık o kadar herşeye sinirleniyorum ki kendi saçımı başımı yolmamak için kendimi zor tutuyorum	kızgın
sürekli sinirleniyorum artık akışına bıraktım neye sinirlendiğimi falan bilmiyorum	kızgın
Git gide tahammülsüz bir insan oluyorum sürekli sinirliyim galiba ruh hastası oluyorum yavaştan	kızgın
Çok sinirliyim ama sebebini bilmiyorum	kızgın
Ateist gibi davranma mal kendine gel	kızgın
Biz bu trabzona nasıl yenildik düşündükçe sövüyorum sövdükçe sövüyorum yok böyle birşey arkadaş ya	kızgın
Herkes birbirlerinden nefret ediyor ama herkes birbirleriyle samimi.	kızgın
Herkes bir yerlere çekip gitmek istiyor amk tutan mı var lan diye bağıracağım sonunda	kızgın
O kadar sinirleniyorum ki kendime bile niye bu kadar sinirlendiğim için sinirleniyorum	kızgın
Her şeye öfkeliyim, başım da ince ince ağrıyor	kızgın
Lütfen hayatımda ki herşey ve herkes net olsun, belirsizlikten nefret ediyorum. Düşünmekten kafayı yiyeceğim	kızgın
Bazı tarihlere çok kızgınım, takvim yapraklarıyla anlaşamıyorum	kızgın
kuzenime ödev yaptırıyorum birazdan çıldıracağım sanırım	kızgın
Öyle kızgınım ki -40`ta kalsam soğumam..	kızgın
Mesaj atınca sinirden küplere bindim	kızgın
Gripli ve öfkeliyim bu yüzden hepinizi karantinaya alıyorum	kızgın
5gb dün geceden bugüne bitti turkcelli allah alsın yani şu an çok kızgınım	kızgın
Yemin ederim sizinle uğraşamam benimle muhatap olmayın	kızgın
Ay yemin ediyorum başıma ağrı girdi, sinirden köpürdüm bir annenin çaresizliğini görünce!	kızgın
Her şeyin rahatsız ediyor beni nolur defolup git artık nereye gidiyorsan	kızgın
Banko şampiyon olacağımız turnuvada sakatlık ve yedeğimiz yok diye diskalifiye olduk sinirden kafayı yiyeceğim	kızgın
Kendini kime kanıtlamaya çalışıyorsun mal mısın	kızgın
Sakin kalmaya çalıştıkça günden güne artan öfkemden nefret ediyorum.	kızgın
İnternetin kotası doldu çok öfkeliyim	kızgın
Kasıtlı yapılan bir şey özürle düzeltilemez, defol ülkemden	kızgın
En çok toprağa kızgınım ve en çok toprağı kıskanırım	kızgın
Netimi saçma sapan şeylere harcıyorum	kızgın
Sen gerizekalının tekisin anlatsam da anlayamazsın 	kızgın
Herkes gergin şu an anasayfada herkes sinir küpü olmuş	kızgın
Ben annemden boşuna mı yemek yapmayı öğrendim gerizekalı	kızgın
Kimse sana güvenmiyor. Herkes senden nefret ediyor. Yeryüzündeki hastalıksın sen.	kızgın
Dişini fırçalamayan tırnak bakım saç bakımı yapmayan ve kokan insanlardan nefret ediyorum.	kızgın
Millet ne der' diye düşünenlerden nefret ediyorum 	kızgın
Uykumu almadığım zaman kendimi çok agresif hissediyorum.	kızgın
Zeki insanlar daha çabuk sinirlenir diye okudum bir yerde ve ne oldu bilmiyorum bir anda küplere bindim.	kızgın
Çıkıp bağıra bağıra küfür edeceğim şimdi tutamıyorum artık kendimi	kızgın
Antidepresan kullanmaya başladığımdan beri daha da agresif oldum bu işte bi terslik var	kızgın
Hayata karşı öfkeli değilim sana öfkeliyim bebeğim.	kızgın
Sinir küpü olduğum tek kelimelik mesajdan anlaşılıyor 	kızgın
birşey söyleyeceğim diyip 10 saat sonra yazanlara sinir oluyorum	kızgın
Benimle ilgili yorum yapan saçma sapan insanlara hayatımı açıp baksana sen neresindesin diye göstermek istiyorum.	kızgın
Bir daha arap görürsem haydi yallah arabistana diye bağıracağım	kızgın
Sinir küpüyüm bulaşanın canını fena yakarım	kızgın
Tivitlerimi görmesi gereken görmüyor delireceğim	kızgın
Susarak asil olmak bana göre değil illa küfür edeceğim	kızgın
Evin duvarından tut yerdeki halıya kadar öfkeliyim kapı tokatlıcam birazdan	kızgın
Bir yaş daha... Ne çabuk geçiyor yıllar kafayı yiyeceğim	kızgın
Sizi zerre umursamayan insanlar için deli gibi üzülüyorsunuz. mal mısınız?	kızgın
Sabaha kadar cs go atıp ruslara küfür edicem	kızgın
Mal mısın madem tekrar engelleyeceksin neden kaldırıp mesaj atıyorsun	kızgın
Ya bu Ayşe mi Banu mu kaç doğumluydu bu kız ya delireceğim	kızgın
Verdiğim değere karşılık alamayınca değil, nankörlük edilince sinir oluyorum	kızgın
Saçma sapan şeylerle oyalanıyoruz. Hiçbir şey gerçek değil. Biz de	kızgın
Hala dört bin gösteriyor kafayı yiyeceğim	kızgın
Bu aralar agresifim kompleksliyim ama perdelerimi kaldırdığımda kedi gibi bir insanım	kızgın
Yine güzel bir çay içemedim, agresifim	kızgın
Sebepsiz yere arıyorum çalarken açarsa ne diyiyeceğim diye düşünüyorum açmayınca da sinirleniyorum	kızgın
Okuldan ciddi anlamda nefret ediyorum eskiden arkadaş var en azından derdim şimdi onlar da yok	kızgın
Bugün var ya çok agresifim, sağa sola çatıyorum az önce virajdan dönemeyen arabaya saydım sövdüm gömdüm	kızgın
Allah'ım çıldıracağım. Yemin ederim çıldıracağım sinirimden. Bir yerden de çıkaramıyorum cam çerçeve indireceğim şimdi ne varsa.	kızgın
Nefretimiz elektriğe dönüştürülebilseydi bütün dünyayı aydınlatmaya yeterdi 	kızgın
Bir ara çok sinirleniyorum sonra geçiyor sinirim	kızgın
Elektrikler yok delireceğim şarjım olmuş %10	kızgın
İstifa etme kovdur kendini mal mısın	kızgın
Google'un her soruya bir cevabı var çok sinir bozucu ya	kızgın
Sinirlenince gözlerimin dolmasından nefret ediyorum	kızgın
Derste aniden kalkıp allahu ekber diye bağıracağım vallahi yeter	kızgın
Doğal olmak basit bir tavırdır ve bildiğin en sinir bozucu tavır... 	kızgın
Tam rüyanın ortasında annem uyandırdı. Agresifim bugün	kızgın
Allah belamı versin ki günün üç saati keyfim yerindeyse geri kalan yirmi bir saat sinir küpü oluyorum	kızgın
Bir şeye sinirliyim ama ne olduğunu ben de bilmiyorum	kızgın
Havaya küfür edicem şimdi ya kış mısın yaz mısın aq bir karar ver	kızgın
eğitim sistemi cidden berbat saçma sapan gerizekalı bir sistem 	kızgın
Madem durmak istemiyorsun hiç durmadan defolup git bu ülkeden mesela	kızgın
Okula gitmek istemiyorum diye avazım çıktığı kadar bağıracağım	kızgın
Yahu şu 7 rakamındaki sır ne kafayı yiyeceğim niye 7 ya	kızgın
bir yandan uzunu izlediğim için agresif hissediyorum kendimi. birazdan umarsızca koşmaya çıkacağım sinirimi atmak için.	kızgın
Sinirimi birilerinden çıkarmam lazım yoksa delireceğim	kızgın
Bu ara herkese sinir oluyorum ya dayak yiyeceğim yada dayak atıcam başka açıklaması yok	kızgın
Erken uyandığım için kızgınım kendime. Bok vardı çünkü.	kızgın
Bir gün her şeyi terkedip deniz kenarında dans ede ede tertemiz delireceğim	kızgın
Gerizekalı gibi iş yapıyosunuz sonra profesyonellikten felan bahsediyorsunuz. 	kızgın
Şu an sinirimden pcyi alıp camdan aşağı atmamak için kendimi zor tutuyorum	kızgın
Aziz kiraz ne ya saçma sapan insanları yutubır yapıyorsunuz	kızgın
O kadar öfkeliyim ki artık kelimelerim yetmiyor bunu atmaya içimden	kızgın
Meclise bak esenler arka mahallesi gibi bizi yöneten kitleye bak yumruklar küfürler kavgalar yazıklar olsun hepinize 	kızgın
Kimseye hayır diyememe huyumdan nefret ediyorum.. Ne gelse başıma bu yüzden geliyor.	kızgın
İnanılmaz agresif hissediyorum boş ve manasız bir öfke var içimde bulamıyorum sebebini yaşayıp geçirmiş olan dm 	kızgın
Uzun bir süre girmeyip tekrar online olunca tuhaf oluyormuş takipten çıkan herkese ana bacı sövüyorum 	kızgın
21 yaşındayım baştaki tivit silinmiş sinirliyim 	kızgın
Az önce sodayı açmaya çalışırken her yere döktüm sakar ve öfkeliyim şu an	kızgın
Şu an o kadar sinirliyim ki ilk gördüğüm insanı öldürebilirim	kızgın
Esra Erolu çileden çıkartan şalvarli gelin adayı kadar agresif hissediyorum	kızgın
Beyin bedava iken, gerizekalı olmak ciddi bir yetenek işidir... 	kızgın
Acıkınca sinirleniyorum bana hemen yemek getirin.	kızgın
Of ağzımdaki uyuşukluk geçmedi hala delireceğim	kızgın
Ya param yokken yapmayın şu indirimleri sinirleniyorum 	kızgın
Çok güzel küfürler biliyorum ama kadına yakışmıyor diyorlar.	kızgın
Şu an sokağa çıkıp sağda solda eyşana küfürler saçmak istiyorum sinirden delirdim resmen	kızgın
sinirliyim ve bu beni daha da çirkin yapıyor	kızgın
Yaşadığım sürece negredoya küfür edeceğim	kızgın
özelden arıyorsunuz niye konuşmuyorsunuz amk mal mısınız	kızgın
Bugün aşırı agresifim, sinirliyim, çıldırıyorum. Allahım 20 yaş sendromu mu bu help me ne olur	kızgın
Küfür eden kızlara itici diyenlere anlam veremiyorum, sinirlenince napsınlar örgü mü örsünler amk	kızgın
Ben mi herşeye çok kolay sinirleniyorum yoksa gerçekten insanlar çok mu sinir bozucu	kızgın
Şu instastory izleyenler neye göre sıralanıyor ya yemin ederim çıldıracağım	kızgın
Agresif oldum. Olur olmadık herşeye sinirlenir oldum	kızgın
Nasıl bir sinir küpüyüm şu an var ya bir dersi almam bir dk sürüyor	kızgın
Şu an öyle bir sinirliyim ki lan ne kadar saçma salak insanlar var	kızgın
Sinirlenince cümle kuramamaktan nefret ediyorum	kızgın
mesajıma cevap vermeyip tweet atan insanlara sinir oluyorum delireceğim bir gün	kızgın
Çok sinirliyim örtmene hastayım diyip gitmeyeceğim derse amk ben matemetik öğrenmek istemiyorum	kızgın
Şu an çok sinirleniyorum her gebze haremi gördükçe, daha ne kadar akraba olma arabası geçecek?	kızgın
Düşündükçe sinirleniyorum, sinirlendikçe düşünüyorum. Kısır döngü girdabındayım... 	kızgın
Yumurtanın sperme gittiği nerde görülmüş gerizekalı ben mi yazıcam.	kızgın
10 gündür çiğköfte yemiyorum delireceğim yakında	kızgın
İçim daraldı yine sinirlendim bak	kızgın
Sesin kulaklarımdan gitmiyor kafayı yiyeceğim.	kızgın
Gördükçe sinirlerim zıplıyor saçma sapan insanları ünlü etmeye bayılıyorsunuz	kızgın
Ya nasıl pislik arkadaşlara sahibim yemin ederim düşündükçe kafayı yiyeceğim	kızgın
Ne çok gerizekalı insan var bu sitede hepsi o kötü atlara binip defolup gitse keşke	kızgın
Abim öğretmen seni gerizekalı. Prim kasmak yerine bana sorsaydın söylerdim	kızgın
Ya bunların derdine ne mal mısın gerizekalı Hayır dedik ya ne orada burada yalan yanlış konuşuyorsun	kızgın
Radyo dinlerken sinir küpü oldum	kızgın
Sıkıldım yoruldum insanların ön plana çıkma istekleri istekleri çıkarları ... yıprandım	üzgün
Dgslilerin sorunu ne integral ne trigonometri.Şimdi sen kaç yıl daha okuyacaksın sorusu.Yoruldum anlatmaktan.	üzgün
Moralim o kadar bozuk ki Avrupa Yakası izleyip moralimi düzeltmeye çalışıyorum şu an	üzgün
Vedaları sevmiyorum, soguk oluyor, acı, mutsuz 	üzgün
Ağlamayla dolu saatler bunlar hep... 	üzgün
Moralim bozuk diye telefon aldım yine moralim düzelmedi. Uçurumdan atın beni ya	üzgün
Bende tükendim ziyadesiyle ama insanlar tarafından değil bizzat kendi tarafımdan	üzgün
Neden yorgunsun sorusuna cevap aramaktan ve bunu sormasınlar diye gülümsemekten yoruldum.	üzgün
İstemsiz moralim bozuk sanırım hoşlanmıştım	üzgün
Tuncelide helikopter kazasında kaybettiğimiz şehitlerimize Allahtan rahmet dilerim, Büyük acı Işıklar içinde yatsınlar Başımız sağolsun 	üzgün
Bilinmedik bir hüzün var içimde .. Bir gariplik.. Yalnızlık mı suçlu, gece mi ..?	üzgün
Cidden çok sıkıldım resmen rezillik yeter artık bıktım	üzgün
Böyle kepaze hayatı sürüklemekten yoruldum arkadaşlar	üzgün
O kadar mutsuzum ki nasıl anlatayım ki?	üzgün
bundan sonra kimseye ücretsiz arkadaşlık hizmeti vermiyorum çiçek gibi çocuğum yıprandım artık	üzgün
Hiç hissetmediğim kadar özgür hiç olmadığım kadar mutsuz hiç düşünemeyeceğim kadar umutsuzum	üzgün
Gratise girdim baba çok pişmanım	üzgün
Bugün birisi yüzüm olmasa yakışıklı olacağımı söyledi kırgınım	üzgün
Tatil bittiği için ilk hafta gitmemeyi düşünmeme rağmen hüzünlüyüm 	üzgün
Moralim bozuk. Canım sıkkın. Param yok. 	üzgün
aykut kocaman takımın başında haberiyle uyandım ya çok mutsuzum	üzgün
Artık kısa cevaplar ve terslemelerden çok sıkıldım sürekli aynı replikler boğuyor 	üzgün
İnsanların işi düşüklerinde aranan ve her işlerini çözen insan olmaktan bıktım, yoruldum artık... 	üzgün
İstanbul şartları olup bitenden daha fazla etkilenip üzülmeye elden bir şey gelmemesine ve mutsuzluğu katlamaya birebir 	üzgün
Gitmekten yoruldum, artık sadece bir kenarda oturup soluklanmak istiyorum.	üzgün
Yemin ederim yıldım, bıktım ya beni bir salın	üzgün
Hissediyor musun bilmiyorum ama çok özledim.	üzgün
Bıktım 2.438 takipçiden ya unf atın azalsın ya da bir şekilde artsın	üzgün
Sigaram bitti dışarda fırtınalı yağmur var ve ben kafamı duvara vura vura ağlıyorum.	üzgün
Ne zaman alışveriş diye çıksam birşey almadan geri dönüyorum çok mutsuzum 	üzgün
Ya artık evlende kurtulayım şu stalk işinden yeter bıktım	üzgün
20'lik dişim çıkıyor ağlamak üzereyim sürünüyorum	üzgün
hoca salda bir patlangaç yapıp geliverek bunaldım dertlendim gari	üzgün
İnanki ağlamadım hüzünlüyüm sadece 	üzgün
ben ağlamaya gidiyorum. 	üzgün
O kadar yoruldum ki herşeyden yanlış durakta indiğimi bile ana caddeye çıkınca anladım	üzgün
19 liralık para üstünü bozuk para olarak veren garanti atmye kırgınım	üzgün
Bir şey beklemiyormuş gibi yapıp içime dünya kadar umudu sığdırmaktan da yoruldum.	üzgün
Farkettim de son 5 gündür falan tweetlerimde vize kelimesi göze çarpıyor. Çok yıprandım.	üzgün
Özledim gökyüzü kadar uçsuz bucaksız	üzgün
Özlesem de özledim diyemiyeceğim kadar üzdüler beni. Bende susmayı öğrendim...	üzgün
Şu İstanbul’un insanı kadar menfaatçi insanlar görmedim ben Kıbrıs’ı özledim hocam	üzgün
Bu hava beni mutsuz olmaya zorluyor 	üzgün
Kuzenim trt cocuk dergisini alamadı diye ağlıyor keske benim de tek derdim bu olsa	üzgün
O kadar mutsuzum ki en fazla bu kadar mutsuz olunabilir	üzgün
odamda örümcek var çok fazla üzgünüm her yerim kaşınmaya başladı kocaman	üzgün
ölmüşüz ağlayanımız yok kokmuşuz tuzlayanımız yok 	üzgün
Yolda yürürken birden yere oturup tükendim yeter demek istiyorum	üzgün
Fena şekilde hüzünlüyüm, dışarıdayım ve kulaklığım yok. Bu hayattaki görevim bitmiştir.	üzgün
Ya bıktım ben bıktım insanların beni aptal yerine koymasından bıktım 	üzgün
Ben teen wolfu özledim ağlayacağım şimdi	üzgün
Türkiyede diziler neden 2 saat ya vallahi bezdim artık izlemiyorum alın dizinizi başınıza çalın	üzgün
Of bu sabah kimse mesaj atmamış günaydın falan filan diye, kırgınım	üzgün
Pişman değilim ama keşke daha iyi şartlar altında kendime yazık etseydim	üzgün
Doktora ilaçlarımı söylerken bile yoruluyorum. İçmesi ayrı yutmadı ayrı oy tükendim	üzgün
Önce biraz zor gelecek ama alışacaksın üzülmeye 	üzgün
Hayat beni neden yıpratıyorsun 	üzgün
Sürekli, yaptıklarım için pişman değilim diyorum ama aslında köpek gibi pişmanım herşey için. Allah belamı verecek.	üzgün
Anlamak istemeyen anlamak isteyenin vaktini çalmasa keşke 	üzgün
aşkım çok kötüyüm hemen beni istemeye gelebilir misiniz.	üzgün
İrmik helvası yaptım ve öküz gibi yedim, pişmanım.	üzgün
Ben artık kendimi savunmaktan yoruldum demekten bıkmadınız mı 	üzgün
Mutsuz yalnız ve fakirim. Uf ya. 	üzgün
İçim yanıyor ağlıyorum kahr oluyorum	üzgün
Bir umuda sarılarak yaşıyorum ama aslında çok umutsuzum.	üzgün
Keşke akrabaları kendimiz seçebilsek muhteşem bir sülale kadrosu var kafamda 	üzgün
her gecenin göğsünde ayrı bir hüzün yatar; ah ne uzundur kuşatılanın gecesi, sarmalayamadığından... 	üzgün
Diyelim ki ben bu gece çok kötüyüm. Nasıl teselli edersiniz	üzgün
İstanbul şartları olup bitenden daha fazla etkilenip üzülmeye elden bir şey gelmemesine ve mutsuzluğu katlamaya birebir 	üzgün
O kadar moralim bozuk ki zorla bile gülemiyorum	üzgün
Ben gözlerimi bir sana açmışken senin bakar gibi yapıp dünyayı seyretmene kırgınım.	üzgün
Yemin ederim hayatımın en umutsuz dönemlerindeyim ya bir şeylere heves etmeye bile halim kalmadı.	üzgün
O günden beri, evet seni sevdiğim, unutmak istediğim o günden beri çok mutsuzum..	üzgün
Hayat bilgisi izleyip ağlıyorum. Psikolojimin farkında mısınız?	üzgün
Trabzondayken evde olduğum her saat için hüzünlüyüm	üzgün
Her akşam aynı hüzün, yol gözler iki gözüm...  	üzgün
Basketbolu çok özledim :( 	üzgün
Böyle denk gelişler olmasa keşke	üzgün
Hafız beni ağlatma zaten üzgünüm	üzgün
Eski fotoğraflara baktım evrim geçirmişim kimler varmış kimler yok olmuş hüzün kapladı içimi..	üzgün
Pijamamın cebi ve yatağımın yanında üçlü priz olmasına rağmen mutsuzum yuh	üzgün
Erkek arkadaşıma 60 liraya kazak aldım . pişmanım ... 	üzgün
Nefes alamıyorsam demek.... bunaldım.....	üzgün
Hayattan vazgeçemeyecek kadar korkak, hayata tutunamayacak kadar umutsuzum	üzgün
Üzgünüm, mutsuzum hayatınız yolunda gitmediğinde ne yaparsınız...	üzgün
küfür olduğu için üzgünüm yakışmadı bana	üzgün
Dünyanın en sıkıntılı durumu metroda çişinin gelmesi ben ağlıyorum şahsen başka çözümüm yok	üzgün
Michaelın kaş piercingini özledim bir de renkli saçlarını	üzgün
Ne zamandır grip olmuyorum ne kötü bişeydir bu ya berbat hissediyorum kolumu zor kaldırıyorum ya! Ve gözlerim doluyor 	üzgün
Kendimi birilerine anlatmaktan o kadar sıkıldım ki artık soranlara boş adam imajı çiziyorum.	üzgün
Yavşağın biri son ses Azer Bülbül açmış durduk yere dertlendim	üzgün
Batak oynayan gelsin sıkıldım anam	üzgün
Belki bizim kaderimiz mutsuz olmaktı 	üzgün
Yakın geleceği merak etmekten yoruldum bu bir hafta geçmez artık	üzgün
Bugün bu hayat beni çok yordu ya yemin ederim yıprandım fanusta yaşıyorum	üzgün
Kankam nöbete gitti bir miktar hüzünlüyüm ama yarın görürüm	üzgün
Beyin henüz transfer edilemiyor sizin için üzgünüm	üzgün
Şu okulda bir şeyler kaybetmekten sıkıldım artık Okul okul değil kara delik sanki 	üzgün
Yıprandım ya daha ne kadar sömürebilirsiniz acaba	üzgün
Afrin'de 5 Canımız şehit oldu çok üzgünüm..Allah'tan rahmet, yakınlarına sabır ve başsağlığı dilerim...	üzgün
Kendimi güçlü falan hissetmiyorum tükendim artık	üzgün
kendimi üzgün hissediyorum, sanki tüm dünya’ya kırgınım.	üzgün
Emlağım olsada emlak vergisi ödesem keşke ... 	üzgün
yolda yürürken birden yere oturup tükendim yeter demek istiyorum	üzgün
Yoruldum. Yıprandım. Tükendim. Ben bu sefer harbi bittim.	üzgün
Çok yoruldum, hüzün uyutmuyor. 	üzgün
Git buralardan herkesi arkanda bırak git mutsuzluğunu al yanına gözyaşlarını topla git 	üzgün
Umut bağlamaktan sıkıldım ve her defasında kırılmış bir kalp	üzgün
Aklıma Fernando geldi, moralim bozuk	üzgün
Bilinmedik bir hüzün var içimde, bir gariplik. Anladım ki, ya ben fazlayım bu şehirde yada biri eksik.	üzgün
Çiçeklerin boynunu bükmesine bile üzülüyorum kış gelmesin 	üzgün
çok sıkıldım ya siz sıkılmadınız mı gençler sanki saat geçmiyor	üzgün
Moralim bozuk ve kalbim hiç olmadığı kadar kırık	üzgün
O kadar yorgunum o kadar tükendim ki olmayan şeyler duyup görüyorum	üzgün
Bir hayli yorulmuştum üstüne bir de yıprandım...	üzgün
Fiziğin yeniden yeniden yeniden allah belasını versin ya yeter ya bıktım 	üzgün
Ben neden bu yaşta hayattan bezdim ya	üzgün
Üzülüyorum sıkılıyorum kötüyüm	üzgün
Saat 6 dan beri uyuyorum. Ama hala mutsuzum.	üzgün
Twit atarken az samimi olun yapmacık şeyler okumaktan sıkıldım artık	üzgün
O kadar mutsuzum ki yatağıma yatıp şarkı dinleyerek uykuya dalmak istiyorum ve sonsuza kadar o yataktan çıkmamakta tek hayalim	üzgün
Bıktım artık sınav sonunda doğrularımı saymaktan artık yanlışlarımı saymak istiyorum :((	üzgün
sabah şekeri olamayacak bu twitler üzgünüm. zaten dünya böyle bir yer.	üzgün
Kaybolmuş gibiyim, nereden başlayacağımı bulamıyorum. Sanırım tükendim.....	üzgün
Bu hafta ben. İlk defa vize haftasında bu kadar yıprandım	üzgün
yıldım, yoruldum, tükendim, bunaldım, bıktım, bezdim, sıkıldım, tahammülsüzleştim, bunların tüm sebebi VİZELER	üzgün
En ufak abartı yok bu diyeceğimde. Bazı günleri, bazı insanları ve bazı anları özlemekten soldum, tükendim, halim kalmadı.	üzgün
Üzgünüm size çok destek olamıyorum hafta sonu malum misafirlik 	üzgün
Moralim bozuk değil ama iyi de değil, bir derdim yok ama varmış gibi, kötü değilim ama iyi de değilim. Falan filan... .	üzgün
Yine 10 lu halleyi bitirecek kadar üzgünüm	üzgün
Kulaklığımı yolda düşürmüşüm çok üzgünüm..	üzgün
Keşke hayal kırıklığı zayıflatsaydı, ne güzel şimdiye kadar yok olmuştum	üzgün
Biri benim yerime yaşayabilir mi benim halim kalmadı da	üzgün
Üzgünüm ve artık bunun benimle de alakası kalmadı	üzgün
Yorgun mutsuz ve umutsuzum	üzgün
Hayat artık beni diskalifiye et gözünü seveyim tükendim	üzgün
Sen benden gittin gideli mutsuzum :(	üzgün
Tae fancafe attı hemde fotoğraflı ama finger heart yapmış, ağlıyorum	üzgün
kuş banyoya girmiş çıkmıyor giremiyorum ben de o yüzden ağlayacağım	üzgün
Yine herkes Maraş'a gittiği için biraz mutsuzum	üzgün
orta okul günlerimi özledim ben keşke geri dönebilsek	üzgün
Bugün yapılan hain saldırıda hayatını kaybeden vatandaşlarımıza Allahtan rahmet yakınlarına başsağlığı yaralılara da acil şifalar diliyorum 	üzgün
o kadar mutsuzum ki artık kalbim fiziksel mi duygusal mı acıyor anlayamıyorum	üzgün
Özledim diyorsun mektubunda. Sadece kuru bir özledim mi yazdı yanık yüreğin. 	üzgün
Markete gidip dünyayı alıp evde dizi izleyerek ağlayacağım çünkü yarın okullar açılıyor	üzgün
Çok fena stalka düştüm mutsuzum	üzgün
Yine bir dönüş vakti Ve içimde bir dem hüzün..	üzgün
Her sene kurtulcam bu şehirden demekten ben yoruldum. Bir sal artık beni ya. Bu son kış olsun yeter.	üzgün
Hayatta çok üzüldüm ağladım, çok yıprandım ama yaptığım hiçbir şeyden bir deneyim diye aldığım farklı rimel kadar pişman olmadım.	üzgün
Üzüntüden, ağlamaktan kirpiklerim dökülüyor çok güzel şimdi de onları nasıl uzatacağım diye ağlıyorum.	üzgün
Bugün çok mutsuzum. Hava da rüzgarlı. Rüzgarlı havalarda ben hep mutsuz olurum zaten.	üzgün
Bu aralar bir melankoli bir hüzün kapladı içimi Sebebi koparılan çiçekler	üzgün
Artık İngilizce dersler çalışmaktan bıktım.. Bir an önce vizeler bitse de Portekizce, Almanca ve İspanyolca çalışmaya geri dönsem	üzgün
Darılma bana çok sıkıldım artık	üzgün
Yazılılar her şeyi engelliyor bıktım bıktım stresinden de kendisinden de	üzgün
Kendimden taşınmak istiyorum artık çok yıprandım yeni sıfır bir ben lazım bana.	üzgün
Acil servisi o kadar özledim ki ağlamak istiyorum	üzgün
Arkadaşlarla yazın kaçmak için tek çarem kolumu kırıp rapor almak üzgünüm	üzgün
Neyseki şu ağlatan diziler varda ağladığımızda neden diye sorulmuyor	üzgün
Çok yoruldum artık, Her şeyden uzaklaşmak istiyorum.	üzgün
Şu an dışardan korkutucu sesler geliyor sanki kıyamet	korku
Ölüm kötü insanlar için çok korkunç bir bekleyiştir. 	korku
Türkiye'de çocuk olmanın bedeli korkunç... Bebek ölüm hızı binde 12... 2016'da zorla... 	korku
Beni pijamalı evden çıkartıp markete gönderen hayat karşıma tarkan'ı çıkartacak diye ödüm koptu	korku
Oha ödüm koptu o nasıl şiddetli gök gürlemesiysi o öyle	korku
1 haftadır her gün kabus görüyorum yeter Allah'ım ne istiyorsun benden	korku
Efes'in 16 basketin ancak altısını asist üzerinden bulabilmesi biraz endişe verici. Guardlar toplam 1 asist.	korku
Kendimi burada bulmaktan korkuyorum 	korku
Yastığımın altından siri konuştu çok korktum be	korku
Yani irkilmeyene kadar izleme kararı almıştım, ses açıkken her defasında irkildim.	korku
çok korktuk ya of çok korkuyorum jackson gelip engel olucak diye ellen'a da gelir falan üf	korku
Yaşarsa konuşma ihtimali çok yüksek onun icin daha endişe verici, ölürse sorun ortadan kalkar!	korku
nehir değil okyanus ve sadece yüzeyi bulanık, derinlerinde ürkütücü bir duruluk mevcut.	korku
Demin deprem olduğunu sandım ödüm koptu ellerim çok titriyor korkudan ya	korku
Hayatımın ilk travması çok küçükken evde tek başıma korku filmi izlememdi	korku
Elektrik gidince İdil sokağı. Böyle bir karanlıkta okula gitmek korkutucu oldu. 	korku
Ben bugün seni rüyam da ölü olarak gördüm çok korktum çocuk allah korusun	korku
Çok korktum :(( hayatım gözümün önünden film şeridi gibi geçti	korku
kuş fobim var ama evde kuş yaşıyor?	korku
Gecenin bu saatinde hemcinsimden bu mesajı aldım, ciddi anlamda ürktüm, bu mesajı başka kişiler tarafından neden almıyorum Allah'ım? 	korku
İnsanın aciz olduğunu ara ara Rabbimin hatırlatması... ürkütücü bir manzara. 	korku
Korkunç be hareketlere bak ürktüm şahsen	korku
geçmişe dönüp bakmak dahi istemiyorum çünkü sen varsın, gülüyorsun ve yine yeni yeniden severim diye korkuyorum	korku
Bazı oteller lüks ve konforlu olması ile meşhurdur, bazıları ise ürkütücü olmalarıyla. 	korku
Tekirdağ’da trafik kazası : 1 ölü, 3 yaralı 	korku
Garezi izlediğim güne lanet olsun korkunçtu 	korku
Ya intihar etmiş ya of kabus gibi	korku
Şu an bile irkildim bu film hayatımı kaydırdı bilimkurguya düşman etti 	korku
Dow Jones herkesi yeterince korkuttu. Biraz yatay takılıp sonra yükselebilirsin mr. kovboy	korku
Spagetti hariç diğer makarna şekillerine karşı fobim var.	korku
Gökselle ortak noktamız varmış, ikimizde gök gürültüsü korkuyoruz...	korku
Kabus da rüya da aynı ikisi de geçiyor ölüm gibi vakit gibi	korku
Manyetik alan fobim var artık	korku
Bu tarz sessiz sakin havalardan nedense korkuyorum fırtına öncesi sessizlik gibi 	korku
kız bana squat mı yapıyorsun dedi korktum nerelerimi dikizliyon sen	korku
Sevenler Ölüme bile birlikte yürürler, çünkü ölüm bile ayrılıktan daha korkunç değildir.	korku
birinin telefonu çalınca neden ben geriliyorum acaba lütfen herkes sessize alsın ben korkuyorum	korku
Matçıya kısık sesle sus dedim hoca duydu tamam dedi amk sikecek diye çok korktum	korku
Payitaht İstanbul daha ürkütücü ama Dünya için ;)	korku
Az önce BlackPink house'un üzerine düşüyordum çok korkutucuydu	korku
Bir korku filmi izleyim de korkudan altıma sıçıp gece uyuyamayayım Allah'ım ne kadar da çılgınım	korku
Aklımı kaybetmekten değil de bulmaktan çok korkuyorum...	korku
Korku çok acı kabus gibi Yazamayanları anlayabiliyoruz	korku
Böceklere karşı fobim var diye habire onlarla karşılaşmaktan BIK-TIM	korku
Soy ağacıma baktım resmen Ortacalıymışız kabus gibi bunu nasıl sildirebiliyoruz	korku
Eğer yanıtlarım seni korkutuyorsa, korkutucu sorular sormaktan vazgeçmelisin.	korku
Yalnız her ikisinin de içinde gizliden gizliye büyüyen bir korku vardı: Bir gün gelip ayrılmak korkusu.	korku
Fernando ikinci sarıyı görecek diye ödüm koptu	korku
Korkuyorum cesaretim kayıp 	korku
Göğsü öne verip direksiyona yapışmakta istemezsin inşallah endişelendim..	korku
Zaman çok korkutucu bir kavram	korku
hoca peltek bu kez derken buket anladım irkildim kadın adımı bile bilmiyor	korku
Arkadaşlar her an birbirimizin ölüm haberini alabiliriz sizce de bu çok korkunç değil mi	korku
Bir rüya gördüm çok korkunçtu.	korku
Bunca patlama ve kan revanın ardından böylesi bir yağmurun İstanbul'u yıkaması çok ürkütücü değil mi? Yeryüzü hiç durma ölüyor ve diriliyor.	korku
Kaybolmuş corabın bulunamayan teki gibiyim . Hadi çıkarın artık beni buradan , çok soğuk ... korkuyorum	korku
Çok ürkütücü konuşmuş, kuş taraftarı..	korku
Allah'ım öyle korktum ki.. kalbim sıkışıyor.. Kendine çok dikkat et 	korku
Dün komple rüya olsaydı kocaman bir kabus gibi hatırlasaydım ..!!!!	korku
Yere çakılana kadar düşüşünü uçuş sanmak ne korkunç bir imtihan.	korku
İçimde biriken hislerin birdenbire patlayarak, beni zerreler halinde dağıtacağından korkuyorum.. 	korku
Ay Onur beey sizi o kadar iyi anlıyorum ki benim de düdüklü tencere fobim var	korku
Sabahın bu saatine kadar kaç korku filmi bitirdim hepsi kabus olacak, uyudu.	korku
Saçımdaki lastik tokanın kopmasıyla irkildim, vallahi çok korkakmışım	korku
Durduk yere endişelendim şu an.	korku
patlama sonrası çok fazla ölü var 	korku
Bu cümle beynime kabus gibi çöktü uyuyamıyorum.. 	korku
Hemen dibimde patlama oldu ve asıl ürkütücü olan, uzakta da olsa korkulacak şey dibimde olunca bile sıradan gelmeye başladı.	korku
Stockholm'de bir kadın ölü bulundu	korku
Bu nasıl bir havadır be. Kapkaranlık uu dışarı çıkınca resmen ürktüm	korku
Son görülme saatin endişe verici rakamlara ulaştı.	korku
Sana bir şey olacak diye o kadar korkuyorum ki gözlerim hep biraz ıslak	korku
Dünyanın en saçma rüyasını gördüm ama çok korkunçtu	korku
4 saat uyudum. Hollywoodun filmleri kıskandıracak bir kabus gördüm. Biraz korktum yani.	korku
Böyle rüya mı olur kabus gibiydi resmen	korku
Bunlar bizide yakacak ondan korkuyorum	korku
Söz de uyuyacaktım yine uykum kaçtı ürkütücü bir foto	korku
Sonunu bilen kelebek kadar endişeliyim... 	korku
Hasta olunca çocuklaştığımdan mı, ilaçların etkisinden mi bilmem ama balkonda uçuşan çarşafları hayalet sanıp ürktüm az önce	korku
Ne yani, böylesine korkunç bir dünyanın birde cehennemi mi var?	korku
Bir toplumun kötüde ve kötülükte birleşmesi ürkütücü.	korku
Sizinle aynı havayı almaktan... Gerçekten irkildim.	korku
Arabalarınızın koltuklarına maske koymayın sabah sabah ödüm koptu	korku
Kedilerin Diğer Hayvanlardan Daha Korkutucu Olduğu Anlar 	korku
Akıllara zarar böcek fobim var.. Öyle ki kalp atışlarımın hızı değişiyor..	korku
Sayenizde öğrendik; zehirli olmasa da görüntüsü ürkütücü... 	korku
hava soğuk diye çamaşırları evin içine astık. ödüm koptu pelerinli bir şey geziyor evde sandım bornozmuş	korku
Kararlılığınıza hayranım. Öyle ki, dünyayı yerle bir etmenizden korkuyorum.	korku
Ölmekten korkmuyorum ama sevilmeden ölmek ürkütücü	korku
Korkuyorum, bir gün etrafıma ördüğüm duvarların altında kalacağım diye	korku
Lütfen arkadaşlar imkanı olan ulaşsın çok endişelendim ben de	korku
Benim çok oluyor bir anda nefesim kesiliyor sanki ölüm anını yaşıyorum çok korkunç 	korku
Geçen hafta peşpeşe 3 gün kabus gördüm şükür ki balık hafızalıyım içeriğini hatırlamıyorum ama içimde bir şeylere karşı korku hissi var	korku
her gün başkalarının yerine utanmaktan utanmaz arlanmaz bir adam olup çıkacağım diye korkuyorum... 	korku
Uçaktan inince herkesin önüne geçmek gibi bir hata yaptım arkamda 100 kişi var yanlış yöne gideceğim diye ödüm koptu	korku
Anla ben büyük harflerden ürktüm	korku
Makarna yapmaya çalışırken evi yakıyordum amk ödüm koptu nasıl bir modelim anlamadım gitti	korku
Twittera da story özelliği gelecek diye çok korkuyorum	korku
Havai fişek fabrikasında patlama: 2 ölü	korku
Kardeşim elinde iğneyle kapıda bekliyormuş, korku filmi gibi ev	korku
Sabunlanan fare çok ürkütücü değil mi?	korku
Dünyanın en kötü rüyasını gördüm pompalı tüfekle annemi babamı ablamı vurduktan sonra intihar ettim aşırı korkunçtu	korku
Uzun süren aralar endişe verici.	korku
İstikrarsızlık giderek yayılıyor olması endişe verici. 	korku
Şarjım 1 di ekran kapanınca telefon kapandı sandım ödüm koptu	korku
Bu yeni kuş ne biçim suratıma atlıyor ödüm koptu resmen	korku
Candy crush oynarken zamanı ileri aldığımda mı aramış acaba ya ödüm koptu 	korku
Gözleri keskin, gözleri keskin, gözleri keskin bir tren sesi kadar korkutucuydu..	korku
ya benim yaşlı amcalara teyzelere fobim var galiba korkutuyorlar	korku
korkuyorum titriyorum üşüyorum	korku
Patlama çok büyük... ürkütücü rakamlar var. Allah korusun Yarabbi :(	korku
Dünya daha korkutucu bir hal aldıkça sanat da daha soyut hale geliyor.	korku
Otobüsteyim yanımdaki kadın müge anlı izleyip çay içiyor bazen de YUH cani şerefsiz diye tepkiler veriyor ürktüm	korku
Başınıza bir hal geldi diye çok endişelendim.	korku
Kabus gibi bir günün içindeyim ve bitmiyor.	korku
Yalnızlığın korkunçtu bahanesi. Her nefes alışında cigerine batıyor, battıkça alıştırıyor ve aynı yerden tekrar tekrar kanatıyordu. 	korku
E bende az psikopat değilmişim korktum 	korku
Samuru ödüm koptu böbreklerimi bıraktım resmen	korku
Volkswagen’in maymunlar ve insanlar üstünde yaptığı korkunç deneyler, film senaryosu gibi ama maalesef gerçek. 	korku
Ünlülere mention attığım korkunç dönem. Üç kişiye attım ama korkunçtu yine de. 	korku
Sonra durdum ve dedim ki, korku filmi izleme, metal müzik dinleme! Psikolojin bozuluyor. 	korku
Unnie seni kaç kere aradık! Çok endişelendim.	korku
Bir an ödüm koptu 10 sene sonra kendimi ağaçkakan gibi göreceğim diye. Çok şükür 22 değilmiş 	korku
Serra birden şiir okumaya başladı korktum	korku
telefonumu titreşime almıştım mertcanın bildirimlerinden sonra daha da almam korktum amk	korku
Bir kaç haftadır boş vakitlerimi evde uyuyarak geçirdiğimi defaatle fark edip irkildim.	korku
batuhanla spor yapıcaz korkuyorum tayt giydi	korku
Kuran çarpsın rüyamda ne gördüysem hepsi tıkır tıkır önüme geliyor bugün, ürktüm	korku
İzlerken çok korkak olduğumu farkettim.bakarken bile ürktüm :)	korku
Mısra aradı ağlıyor dedim niye ağlıyorsun çok korkmuş bir şey oldu diye bana bir şey olsa burada tivit mi atarım	korku
O kadar dişçiye geldim tedavi gördüm hala ilk günkü gibi çok korkuyorum	korku
Bulaşık yıkadım çok korkunçtu bir an ölücem sandım	korku
Geçtim karşısına tam patır patır her şeyi söylüyorum korktum yumuşamaktan	korku
Korktum o nasıl bir bağırıştı	korku
Böyle bir hışımla girdi menşına ben ürktüm	korku
İlk defa bi arkadaşım için endişelendim. gidiyorum buralardan diyip internetini kapadı..	korku
Kapılırsam sonu yok, herşeyi feda edeceğim, ürkütücü	korku
Tarkan, mimiklerinden çok korktum ya. Niye öyle oldu? 	korku
Kapalı alanda duramama fobim var çünkü sigara içiyorum	korku
Sen kork o zaman ben ölürsem hayalet olarak gelirim	korku
Arkadaş bir kabus gördüm, korku aksiyon dalında Oscar'lık.. Kafama çekiçle vurulmuş gibiyim 	korku
İçinizde öldürdüğünüz kişiyi karşınızda görmek çok korkutucu değil mi?	korku
30 mükemmel bir yaş olabilir lakin bana çok korkutucu geliyor	korku
Rüya mı gördüm kabus mu karar veremedim ama etkisinden çıkamıyorum 	korku
Kız şıllık bir sana bir de siyah kedilere fobim var uzak dur benden	korku
Gözleri keskin, gözleri keskin, gözleri keskin bir tren sesi kadar korkutucuydu..	korku
ABD, hala yasal olan bireysel silahlanma ve yine facia bu kez Texas'ta bir kilise, onlarca ölü, toplum olarak ödenen bedel.	korku
Temizlik şirketlerinin çoğalması endişe verici kimse evde temizlik yapmıyor mu? 	korku
Bunun gerçek olabilme ihtimali korkunç, eğer gerçekse çok daha korkunç 	korku
Ah vizeler kara vizeler kabus gibi çöken vizeler	korku
Herşey tamı tamına bir saniye sürdü. Önce şiddetli bir sarsıntı hemen arkasından ürkütücü bir patlama sesi. Sağa sola koşuşturan insanlar... 	korku
Otobüs tekerleği fobim var bugün fark ettim çok ilginç değil mi	korku
Gerçi onlarda ayrı manyak şimdi araştırınca ürktüm biraz	korku
Bu ne yahu kabus gibi bir gündü...	korku
Rüyamda ders çalışmak zorundaydım. Rüya değil kabus adeta.	korku
Fed/Evans, ABD'de enflasyon bekleyişlerindeki düşüş endişe verici	korku
nasıl yağmur yağıyor vallahi ama acayip gök gürlüyor korkuyorum 	korku
Dün neydi öyle ya, cavs kaybedecek diye ödüm koptu.	korku
Kedi yavrulamış ödüm koptu amk ama çok tatlılar	korku
Kerkük'te büyük facia: 20 ölü, 100 yaralı	korku
Pazar günlerinden hoşlanmam fakat bugün çok farklı geçti. Emeği geçen bütün arkadaşlarıma sevgilerimle :) Harika hissediyorum iyi ki varlar	mutlu
Mükemmel bir geceden sonra arkadaşlarımın isteği ile okula gitmeye karar verdim, harika hissediyorum ::))	mutlu
Staja gitmedim çok mutluyum.	mutlu
aşkım benim iyiki doğmuş canımın içi canımdan bir parça oy annesinin gülü iyiki var 	mutlu
hep sevmekten ziyade her gün farklı sebeplerden daha çok seviyorum.	mutlu
Hayat bugün eğlenceli şimdi çarşı zamanı kardeşimin tweettere atmak istediği tweetmiş 	mutlu
Harikaydı çok güldüm hatta yarıldım emeğinize sağlık	mutlu
Nasıl bir enerji varsa havada, kendimi harika hissediyorum, bir de bütün dileklerim gerçek olursa, tutmayın benii :) :)	mutlu
Arif ve 216yı izledim beğendim, snap atmadım, sevinçliyim, gururluyum	mutlu
Bugün benim doğum günüm ???? 21 de bitti 	mutlu
Dünyayı iyilik ve merhamet kurtaracak! 	mutlu
Ankaradayım :) İzmirden sonra ki memleketim olmuş burası ya, harika hissediyorum kendimi keyifliyim :))	mutlu
Yeni yıl sana yeni yıl bana yeni yıl bize kutlu olsun	mutlu
Peaky blinders’e başlıorum çok heyecanlıyım hadi hayırlı olsun	mutlu
Ve annesi o sarı saçlı mavi gözlü bebekle ilgilenmemi istedi. Çok mutluyum şu an... 	mutlu
Bütün gece harika hissediyorum dünyadaki en mutlu kişi benim, tam yatacağım modumu düşürüyorlar, mutlu uyuyamıyorum.	mutlu
russian roulette albümünü açınca oynamadan duramıyorum çok komik	mutlu
Ay bayağ güldüm buna Ethem Başkan ölüleri diriltebilir belki çok mantıklı bir yorum olmuş	mutlu
Her fotoğrafım ifşa niteliğinde çünkü tipim normalde de komik	mutlu
23 Nisan Ulusal Egemenlik ve Çocuk bayramımız kutlu olsun Ayrıca tüm müslüman aleminin Regaip Kandilini kutlarım 	mutlu
Yemek siparişini beklemek hiç bu kadar eğlenceli olmamıştı. 	mutlu
En son ne zaman bu kadar güldüm acaba 	mutlu
Birinin iyi derece soyut matematik eğitimi alabilmesi için neden iyi derecede türkçe biyoloji kimya bilgisi olması gerekli 	mutlu
Aybüke Pusat güzel dans etti vallahi gösterisini beğendim.	mutlu
Sevdiğim insanların da beni sevmesi harika bir duygu	mutlu
hemstırlar çok sevimliler çok seviyorum  	mutlu
Bende ki GALATASARAY sevgisi bir başka	mutlu
Oyuncak uçak aldım aşırı mutluyum şu an	mutlu
Gülşenin genç versiyonu mu diyorlar :) ilk defa duydum. epey komik.	mutlu
Ailesiyle güzel sohbetin ardından söylenen şarkılar türküler ile hepimiz harika anlar yaşıyoruz 	mutlu
Kendime onlara adayacağım içinde kaybolacağım kitaplar aldım, çok mutluyum	mutlu
Akdeniz üniversitesi'nde bir erkek doktora aşık oldum resmen	mutlu
Yine cin olmadan adam çarpmaya çalışanların mallıklarını izleyip eğlendim	mutlu
bu seneki festivaller efsane geçiyor her gün festival olsa da coşsak 	mutlu
Duman ve grup yorum şarkılarıyla ameliyat oldum local anestezide eğlenen tek insan benim herhalde :D 	mutlu
Dünyaya gözlerimi açtığım gün bugün, kendimi harika hissediyorum :) Günaydınlar	mutlu
Zafer bayramımız kutlu olsun 	mutlu
Şampiyon BEŞİKTAŞ'ım ne istersen iste benden ???? 	mutlu
Kulaklarının iyi duyduğu zamanlarda eğlenceli olabiliyor yada bizim eğlence anlayışımız çok farklı :)	mutlu
Feyza bir aşktır onu seviyoruz 	mutlu
Arkadaşlar harika hissediyorum buraya yazayım ki nazar değsin bünye alışık değil	mutlu
Bugün benim doğum günüm 21 de bitti 	mutlu
Yaşasın. Sevgililer gününde sevgilim var.	mutlu
haha cidden düşündüğüm gibiymiş işte buna daha cok güldüm ve tastikledim muhattabım olamazsın	mutlu
Mesleki gelişim 55 mi haha harika hissediyorum	mutlu
pizza ve waffle sevmediğimi söyleyince insanlar çok garip tepkiler veriyo yüz ifadeleri çok komik oluyor	mutlu
Son 2 yıldır hiç bu kadar mutlu olmamıştım. Teşekkür ederim Allah'ım	mutlu
Çok şık hareketler bunlar Eğlenceli bir haftasonu olacak Merakla bekliyoruz :))	mutlu
Sevginize, ilginize çok teşekkür ederim. Tam da şu an mutluyum paylaşasım var 	mutlu
Türk hakemleri gerçekten çok komik :)	mutlu
Bir türk kahvesi içiyim dönerim tekrar sohbet ederiz aşklar öptüm	mutlu
Twittera girdim eğlendim şimdi çıkıyorum	mutlu
Güzel bir spordan sonra simitimi yedim harika hissediyorum :))))	mutlu
Banyo etmek dünyanın en güzel şeyi, dünya varmış demek 	mutlu
Bence bu Ales etiketine yorum yazanlardan müthiş akademisyen olur. Çok güldüm :))	mutlu
küçük mutluluklar yaşamak benim işim 	mutlu
İnstagramdan tüm okullar açılıyor diye birşeyler paylaşan kişileri unfladım mutluyum.	mutlu
Fineas ve förb izliyordum kliplerinin top 10 listesini verdiler çok eğlendim çok mutluyum	mutlu
Son 2 yıldır kendimi emekli etmiştim konferanslardan Lakin 3 tane harika konferansta bulunacağım önümüzdeki 6 hafta içerisinde 	mutlu
Sınavdan sonra 113 tane not kağıdı resmini sildim galeriden Mutluyum	mutlu
Çok güldüm inşallah başıma gelmez	mutlu
Şu ruh haliyle okula koşturmayı, sınavlara girmeyi başarıyorum. Çünkü harikayım 	mutlu
big mouth izliyorum baya güzel beğendim gidip herkese övücem	mutlu
Ben onun o kıpkırmızı gözlerine aşık oldum.	mutlu
Arkadaşlarıma e okul fotoğrafımı atıyorum ve dalga geçiyoruz eğlenceli	mutlu
Geç kalmış doğum günü hediyemiz için teşekkür ederiz 	mutlu
Epey güldüm. Iraklı bir antropologun naif batı kültürü üzerine araştırmaları	mutlu
Beklemeye değdi bu yüz ifadesi çok güzeldi	mutlu
2017 oldu sevindiğimiz şeye bak amk elektriğin gelmesi 	mutlu
Tüm islam aleminin Ramazan Bayramını kutlarım 	mutlu
Bir müzik bütün modumu değiştirdi harika hissediyorum hayaller falan efsane. Herhangi bi şey bunu bozmadan neti kapatıp uyuyorum :D	mutlu
Tarkan'ın baba oluşuna çok sevindim. O nasıl bir haber veriştir. Her zaman çok tatlı. :)	mutlu
Son üç vize çok sevinçliyim; bekleyin beni canım dizilerim... 	mutlu
Ne taraftan baktığına bağlı bu taraftaki pencereden gayet hoş	mutlu
Boş zamanlarında ne yapıyosun diye sorsalar düşme videoları izleyerek eğleniyorum derim, bak yazarken bile eğlendim	mutlu
Neyse eğlendim yemek yapmaya gidiyorum	mutlu
Fenerbahçe forması giyer misin sorusuna şeref duyarım diyen taçsız kral doğum günün kutlu olsun	mutlu
Aslı'nın Ben hayatımda sadece aşık olduğum insanı öptüm deyip Ferhatla öpüşmesi kalp biz	mutlu
Yaşasın cuma yaşasın pijamalarım, panduflarım ve kitaplarım 	mutlu
Ya yemin ederim stalkların en güzeliydi çok güldüm çok eğlendim haha	mutlu
Prison Break 6. Sezon çıkıyormuş muazzam sevinçliyim şu an	mutlu
Yeğenimin oyuncaklarıyla eğlendim	mutlu
Sevgililer gününü seviyorum fakat sebebi sadece indirimler	mutlu
Hepinize sevgiler, saygılar, teşekkür ederim	mutlu
Bugün de eşimle gittim iyi ki gitmişim hem eğlendim hem güldüm 	mutlu
Dünün acısını çıkartarak her saatimi yemek yiyerek geçirdim harika hissediyorum	mutlu
Düğün, söz, nişan gibi etkinliklerde sakinleştirici etki ederek yer almayı seviyorum 	mutlu
ablam babam ben eğlendim geldim çok güldük ya hep böyle olsa	mutlu
Doğum günün kutlu olsun, mutlu ol senelerce	mutlu
Esmoş her türlü entrikaya rağmen güzeldi 	mutlu
bugün yanlış etikete bakıp 10 liraya kocaman parmesan buldum diye sevindim	mutlu
ya ben bugün çok fazla pozitif mutlu bir o kadar neşeliyim kendimi harika hissediyorum :D	mutlu
Bu gece aleynalarda kalıyorum çok mutluyum yaşasın çok eğleniyorum	mutlu
La case de papeli erkenden sorunsuz ve spoilersiz bitirdiğim için çok mutluyum Allahım	mutlu
kadıköy seni çok seviyorum ama kimse yürümeyi bilmiyor	mutlu
Sabah sabah Çok Güldüm Ellerine sağlık emeği geçenlerin 	mutlu
Alttan aldığım dersi geçtim taktir almış çocuk gibi sevinçliyim. Hadi internet kafeye gidip cs oynama vakti.	mutlu
Dünya Pizza Günü’nüz kutlu olsun!	mutlu
O kadar eğlendim ki, telefonun içinden alıp karşıma koymak istedim	mutlu
Rimelim çok güzel kıvırıyor ya kendimi harika hissediyorum şu an	mutlu
Sabah sabah yoga ve spor yaptım harika hissediyorum	mutlu
nceliksoydan mükemmel ikili olduğumuzdan aksiyon filmi tadında hayatımız ¦ iyi mi kötü mü bilemedim gerçi D 	mutlu
epey komik şeyler oluyor sıkı tutunun	mutlu
Etrafımda güzel insanlar olmasına bayılıyorum ya böyle başka bir boyut gibi geliyor sürekli keyifli hissediyorum lütfen çirkin insanlar üremesin	mutlu
Genelde doğru seçimler yapamayan birisiyim ama senin hayatımın en doğru kararıymış gibi duruşunu seviyorum	mutlu
Selim İleriye samimi mektubu ve nezaketi için teşekkür ederim 	mutlu
Sevgili kardeşler 23 Nisanınız kutlu olsun bugün benim doğum günüm İyi dileklerde bulunan tüm güzel arkadaşlarıma teşekkür ederim 	mutlu
Mirayı kız kardeşim olarak atadım öyle çok seviyorum	mutlu
Uludağ’a aşık oldum. Bence o da bana karşı boş değil	mutlu
Daha çok gül çok komik çok	mutlu
Kopyasız matematik sınavından 68 aldım kendimi Harika hissediyorum :3	mutlu
Az önce 7 tane halley yedim şu an harika hissediyorum :)	mutlu
Evet verenlerin ulusal egemenlik bayramını kutlaması lol 	mutlu
Sevindim herşey yolunda gider umarım 	mutlu
Az önce kendi kendime spoiler verdim ama mutluyum 	mutlu
Bunun montaj olduğu çıplak gözle anlaşılıyor. Kendi pisliğiniz bize tutmaz. Kendi pisliğinize solcuları alet etmeniz çok komik. :)	mutlu
Bu gece çok eğlendim gerisini önümüzdeki günlere bırakıyorum	mutlu
Kitap, kahve, polar üçlüsünü seviyorum	mutlu
Çok mutluyum çünki 6 aydır Hatay beni görmemişti	mutlu
Aşkım seni buğradan daha çok seviyorum bende seni öperim	mutlu
Gittiğim gençlik kampı inanılmaz güzeldi.Bütün liderlerimi seviyorum	mutlu
Sıyah beyaz aşk bu akşam kanal d de Çok seviyorum bu dizi	mutlu
Hesabın çok güzel icon bio hepsini beğendim	mutlu
Ya bu kısım inanılmaz güzeldi, Namjoon sana aşığım 	mutlu
İnanılmaz güzel bir sigara içiyorum şu an. Tam istediğim gibi mutluyum	mutlu
Bütün akrabalarımı stalkladımm çok eğlendim	mutlu
Altın kelebekte bir ilk ! İlk defa güzel başladı. vallahi beğendim 	mutlu
doğrusunu bildiğimiz yalanları dinlemek çok eğlenceli değil mi	mutlu
Değil 4 yıl çok uzun yıllar bu formayı giymek ve başarılar yaşamak nasip olur inşallah Allah'ım utandırmasın 	mutlu
Beni destekleyen herkese teşekkür ederim. Sıcaklıklarını hissediyorum. Bu kadar güzel yüreğe girmiş isem kaybetmiş sayılmam.	mutlu
Çevremdeki insanların beni eskisi kadar sevmediğini hissediyorum bu harika bir duygu	mutlu
Gülhan Şen gibi giyinen kızlar çok hoşuma gidiyor çok sevimli..	mutlu
2018 den ilk beklentim gerçekleşti ve istediğim oranda zam aldım bir miktar sevinçliyim :)	mutlu
Güneydoğu Tv de program sonrası. İlgi gösteren tüm izleyenlerime teşekkür ederim. 	mutlu
Bu güzel ve eğlenceli gece için teşekkürler :)	mutlu
Bak o daha güzel fantezi çok da eğlenceli olur ??	mutlu
Ben başaksehire gitmesine üzülmedim aksine bize gelmediği için çok sevinçliyim.	mutlu
Gülmeyi seviyordum, güldürene aşık oldum.. hamdolsun! nokta.	mutlu
Yalnız sınav efsaneydi ben baya baya eğlendim. O kadar eğlendim ki süre nasıl geçti anlamadım! 	mutlu
Yaşasın bugün dizim var!!	mutlu
Beni halı saha maçına çağırdılar yaşasın defansların efendisi vezirin geri dönüşü	mutlu
Coştuk bir kere tutabilene aşk olsun. 4 oldu	mutlu
Otobüste yolculuk yapsak kekimi sana veririm çünkü seni çok seviyorum	mutlu
Hep kardeş olacak değiliz ya, yaşasın halkların sevgililiği!	mutlu
Eğlenceli bir pazar etkinliği olarak hakkın rahmetine kavuşuyorum	mutlu
Ve ilk istifamı da vermiş bulunmaktayım, mutluyum, teşekkürler	mutlu
390knın arasında bende varım sevinçliyim, ilk hafta satışlarına ilk defa tiffanyden sonra girebildim 	mutlu
Twitter arkadaşımla reelde de konuştuk nihayet mutluyum :))	mutlu
Kurban bayramınız mübarek olsun Sevdiklerinizle birlikte nice mutlu sağlıklı bayramlara 	mutlu
Her şey çok güzel geldi bu hafta bence Haftaya da iyi izlenecek.	mutlu
Beni yormadan kendi davranışlarınla boş bir insan olduğunu gösterdiğin için teşekkür ederim	mutlu
İstanbul'a dönüş yapıyorum. İki gün boyunca Trabzon'da çok güldüm çok eğlendim.	mutlu
Millet, burayı gezmek cidden çok güzeldi. Legolarla oynamak çok eğlenceli.	mutlu
Çok mutluyum ya hayatımda ilk defa hukuktan 80 almışım	mutlu
Çok güzel gülüyorsun sevmemek elde değil.	mutlu
Günaydın harika hissediyorum son 2 gündür :)	mutlu
annemden iyi zeytinyağlı sarma yapan herhangi bir varlık olamaz bu evrende gece gece ne gömdüm 	mutlu
Bugün Robinimle sahilde bir güzel eğlendik	mutlu
Yağmur damlasıyla gelen erken çıkabilirsiniz maili sen benim canımsın seni seviyorum.	mutlu
haklısınız çok eğleniyoruz 	mutlu
Hayret ettim kalbime bazen..	surpriz
Bu kadar söven ilk defa oldu ama hakem nasıl duymuyor hayret ettim	surpriz
Piyangonun sana çıkmadığına çok şaşırdım hâlbuki bütün numaralar sendeydi.	surpriz
Hava bulutlu burda hayret ettik nasıl olur da bulutlu olur ??	surpriz
Tokat'lım da sürpriz yaptı	surpriz
8'de uyanıcam diye kendimi ayarlamıştım, resmen 8'de kalktım. Uykumu da almışım hayret ettim.	surpriz
Ya inanmıyorum. Hoseok canlı yayın yapıyor ve ben okula gidiyorum.	surpriz
Ben kendimle savaşırken senin kazanman bana da sürpriz oldu.	surpriz
Bu yavşaklıkla nasıl bu kadar adamlık taklidi yapabilmiş hala şaşkınım.	surpriz
Şok oldum gerçekten büyük bir şoka uğradım. Vallahi billahi inanasım gelmiyor. Bu kadar olur yani. 	surpriz
Milli takıma çağırılmak bana sürpriz oldu. Artık herkesin beni unuttuğunu sanıyordum. 	surpriz
Bitirmiş ya şaşkınlık verici gerçekten insan inanamıyor	surpriz
Burcu ile badegül diye dalga geçiyorduk erkek cıktı, adı da ardaymış ben şok cidden hiç anlamadım 	surpriz
Çocuklara sürpriz yapıp küçük ama güzel hediyeler almalıyım 	surpriz
Bugün hayat soldado nun hat-trick yapması kadar şaşırtıcı ama güzel.	surpriz
Kale anaokulu'ndaki tüm mesai arkadaşlarıma teşekkür ederim. Güzel bir sürpriz oldu... 	surpriz
Yalnız Pektemek kısa sürede iyi oynadı, şaşkınım	surpriz
Ya ya ben bile şoktayım senden bir sürpriz beklerdim	surpriz
Oha gerçekten dünyayı gezmeden önce kendi ülkemi mi gezeyim? Ciddi olamazsın ya bu orijinal fikrin hemen patentini al.	surpriz
Annem şok'tan yumuşatıcı almış ve la vie est belle kokuyor son zamanların en şaşırtıcı olayı	surpriz
Hayret bu şerefsizden bu kadar adil ve düzgün bir yorum son zamanlarin en şaşkınlık verici olaylarından	surpriz
GS kadın voleybol baya iyi oynuyor şaşkınlık verici	surpriz
Hayret niye görüştürülmüyorsa artık! Yeni farkedilen birşey olsa gerek	surpriz
PDR'nin eğitimdeki işlevine siz inanmazsanız kim inanacak. Şaşkınlık verici 	surpriz
Bu tiple okula girdiğine şaştım birde sekreter oha	surpriz
Yok artık inanmam ama olmaz olmaz deme	surpriz
Muavin bir şey içip içmediğimi sormak için beni uykumdan uyandırdı hala şaşkınım	surpriz
Ben de sana hayret ediyorum Anadolu cennet diyorum inanmıyorsun! 	surpriz
Aaa 6Snin yediği gol iptal mi edilmiş çok şaşırdım nasıl olur ya aaa inanamıyorum 	surpriz
Kararlarım bana da sürpriz oluyor	surpriz
Aaa komisere de replik yazmışlar. Ben şok	surpriz
Aaa sahnemiz varmış Şu an şok oldum 	surpriz
Bütün evlatlarım güncelleme yapıyor bugün nasıl bir kral şaştım kaldım vallahi 	surpriz
Fakat üst sınıflarından görmeye alışık olduğumuz dev ekranı A serisinde görmek sürpriz oldu.	surpriz
Bugün kendime bir sürpriz yaptım	surpriz
Çok güzel bir gün geçirdim. Çok güzel haberler aldım, sürpriz şeyler oldu. Hep böyle devam etsin Allah'ım ne olur	surpriz
Cem Korkmaz intihar etmesi neredeyse imkansız bir adam hayret ettim.	surpriz
Sürpriz yaptım diyorsun da ben bir şeylere şaşırmayı o Temmuz ayında bıraktım.	surpriz
Şu bet sesimi beğenen bir kaç insan var hayret ettim	surpriz
Aaa yatağımda hediye paketi var kim bana sürpriz yaptı ya	surpriz
Ne diyeceğimi, diyip demeyeceğimi şaşırdım.	surpriz
Aaa şoktayım, BEIN SPORTS 3 te, Fb ligin en diri takımı dediler, ne oldu bunlara.	surpriz
Hayret ettim kalbime bu kadar şeyi nasıl sineye çekti acaba	surpriz
Kadın dizisinde Sarp bilmecesinde çok şaşırtıcı bir iddia ortaya atıldı	surpriz
Vartoluda ki dövmeyi görünce şok oldum	surpriz
Oğlum bir çikolata kutusu keşfettim içinde tüm markalar var hangisini yiyeceğimi şaşırdım	surpriz
Ya insan insanı bu kadar hızlı nasıl satar şaşırdım :) 	surpriz
Gece tam bunu dedim inanmıyorum	surpriz
Uykuyu tutamadığım gecelerde dönüp de yazdıklarıma baktığımda bazen hayret ettim.	surpriz
Çocuk iki saattir hayvan gibi bakıyor sonra sevgilisi geldi sarıldı ben şok	surpriz
Oha ne izledim ben şu an nefes nerden alınıyordu	surpriz
asansör bozulmuş yine şaşırdım mı hayır	surpriz
O değilde ablam ilk defa twitlerimi beğendi hayret ettim	surpriz
Arkadaş son 12 saat içinde 9 tas aşure nedir ya kendime hayret ettim şu an	surpriz
Uykumuda almışım hayret ettim	surpriz
Babam ve halamlar geliyormuş sürpriz yapacaklarmış gerçekten sürpriz oldu ??	surpriz
Ay ben şok son 10 saatir şeyma storysin'de birşeyler paylaşmadı vallahi acayip merak içerisin'deyim hemen arayıp soruyorum 	surpriz
Bu kadar hızlı 'Tornistan' benim için bile sürpriz oldu	surpriz
sen mi yaptın yok artık inanmam hazır almışsındır :)))) ne bunlar	surpriz
Cem Yılmaz'dan bu denli mütevazı bir açıklama! Şaşırtıcı	surpriz
Aaa sürpriz son varmış	surpriz
Bugün yine on kişiden dokuzu seni sordu bana dondum kaldım 	surpriz
Ne güzel inandırdınız kendinizi kendi yalanınıza hayret ettik	surpriz
Vay çoktan Cumartesi’den yemeye başlamışız bile helal olsun akıyor resmen	surpriz
insan gerçekten hayret ediyor, yetmeli artık bu bekleyiş 	surpriz
Evdekiler ilkokul fotoğraflarımı çıkarmış Nilay çok değişmişsin diyolar oha ciddi olamazsın niye ki allah allah çok garip	surpriz
Hesap yaptım derbi maç sonucunu buldum... bende hayret ettim.	surpriz
Hayret bu sene 10 Kasım da kimse hasta olmadı	surpriz
Hadi yok artık OMG sabah sabah şok edici şeyler öğrenmek sınavım var benim bugün insaf	surpriz
Normalde uykum gelir ama uykum hala gelmedi şaşırtıcı	surpriz
kızın biri bot giymiş kollar göbek falan açık şaşkınlık verici bir durum	surpriz
Birden geldin aklıma yakıverdin ışıkları. Hayret ettim galiba mutluluktan... 	surpriz
Yeşil tavuk yumurtası… Hayret birşey ya	surpriz
Aaa konuşan göt yapmışlar. Ben şok 	surpriz
Oha yemek yemeye gittim geldim maç 2-2 olmuş	surpriz
Allah'ım 1 tlye oje aldım hala inanamıyorum ?? 	surpriz
Güzel bir sürpriz için uygun bir gün..	surpriz
Şaştım üç lisan biliyor okumuş çocuk borumu	surpriz
sen mi yaptım yok artık inanmam hazır almışsındır :)))) ne bunlar	surpriz
Bana inanman için ne yapmam lazım cidden bilmiyorum şaştım kaldım.	surpriz
Bu saatte yoğurt canı çekmiş ve almaya gitti hala şaşkınım	surpriz
Gerçekte çift olmasını istediğim hiçbir shipim yok. Oha.	surpriz
Ya inanamıyorum hadi onları engelledin benim gibi bir ponçiği nasıl engelledin	surpriz
İnsanların 4 yıldır sevgilisi var ya şoktayım	surpriz
Metroda bile çeken telefon evde çekmiyor. İnsan gerçekten hayret ediyor yani	surpriz
Merve yüzünden ilk defa evli birinin başkasıyla sevgili olmasını istedim tövbe kendime şaşırdım şu an..	surpriz
Sorgulamadan inanmama şaştım kaldım.	surpriz
Bunu 11 dakikada yaptığıma inanamıyorum ?? 	surpriz
Oha Akhisar Trabzon'a tersten plaka yazdırmış :d	surpriz
her seferinde bir öncekinden üst level şerefsizlikler ve daha fazla hayret	surpriz
M.E. Bakanlığının müfredatından ve oluşturduğu sistemden, pozitif beklentisi olan için icraatları şaşkınlık verici olabilir.	surpriz
Şu saatte pat diye kalktım. Sonra da şoka uğradım..	surpriz
Bu gece nedense enerjim yerinde neşem yerinde.Ben bile hayret ettim.	surpriz
Şaka falan değil di mi hala inanamıyorum da ben 	surpriz
Almanlar Türk olduğuma inanamıyor. Ben şok.	surpriz
Oha ya Esir bile aydere gitmiş inanmıyorum bilsem bende uçardım	surpriz
SK Hynix sürpriz yaptı, GDDR6 belleklerini piyasaya sürdü 	surpriz
Diyete başlayan ve yoğun ders çalışan ben kendime inanamıyorum şu sıra	surpriz
Daha şaşkınlık verici olanı; Sen bu duruma nasıl şaşırıyorsun Babako	surpriz
Az önce 3kg turşuyu 7 liraya aldım hala şaşkınım	surpriz
Şok oldum gerçekten büyük bir şoka uğradım. Vallahi billahi inanasım gelmiyor. Bu kadar olur yani.	surpriz
Ciddi olamazsın 3 kg balık mı yiyecek ??	surpriz
Anlatmaya çok ihtiyaç duyduğum şu olayları kimseye anlatmak istemeyişim de şaşırtıcı	surpriz
Hayret bugün demedi twwet efendi robot musun..	surpriz
Bitki çaylarından special birşey yaptım yengem bayıldı; ben şok	surpriz
Aldığım karara şaşıran insan görünce şey diyorum inan ben senden daha şaşkınım ya	surpriz
Şok eden polis yemini..! 	surpriz
Yükselen burcum akrepmiş şu an öğrendim şaşkınım	surpriz
Yazarken ben de hayret ettim kendime	surpriz
O değil de o cümleyi bağlaması benim için sürpriz oldu nedense :\ 	surpriz
Vay ne prim kasıyorsunuz tolga'dan ha	surpriz
Van depremi gibi sallantılar aynı düzlemde mi? Ne ara bu kadar yardım ayarlandı da gönderildi. Maşallah... hayret ettim bak.	surpriz
6 yaşından sonrası banada sürpriz oldu, oran 12.50	surpriz
Yok daha neler efendi adam ama uzun vadede asla olmaz.	surpriz
Kışın içilen çorbanın şaşırtıcı faydaları 	surpriz
Bende unutuyordum sonra tarihe bir baktım 17 kasım ben şok	surpriz
Serdar bir dur amk ya.. bir sakatlanma ya.. hayret birşey	surpriz
Az önce otobüs şoförü ortalar bomboş ama ilerlemiyorlar diyen yolcuya yok abi neresi boş dedi. Şoktayım	surpriz
Topalla stoper olmuyorsa neden isla'yı denemez bu hoca hayret birşey.	surpriz
Anneme sürpriz yapıyordum ki annem bana sürpriz yaptı....	surpriz
Oha türkçe destekleri bile var 	surpriz
Dondum kaldım resmen ne pozisyon kaçırdılar be	surpriz
Stalk çok şaşırtıcı bir olay eninde sonunda dönüp dolaşıp başladığım profilde buluyorum kendimi	surpriz
Yine aldığım kararlar en çok bana sürpriz oldu	surpriz
Zamanı gelmişti ama yine de Tesla Roadster konsepti büyük sürpriz oldu. 0-100 km/s: 2 sn! 	surpriz
Bu ödülü bize vermezler diyorum şaşırdım doğrusu 	surpriz
Az önce bi dolmuş şoförü yayaya yol verdi hayret ettim. Hayır normalde 50 cm bile bulsalar burunlarını sokuyorlar ya.	surpriz
Oha benimki öylesine bir umut da sen belki arkasından geçtin	surpriz
Evet anne siz şimdi beni salondan çıkardınız ya ben hiç anlamadım pasta getireceğinizi aaa sürpriz oldu pasta mı aldınız çok şaşırdım	surpriz
Aaa şu şey değilmi ya , sevmiyorum diyipte pişman olan ??	surpriz
Gitsem gidemem,kalsam kalamam. Şaştım bu işe diyen Çelik çaresizliği var üzerimde.	surpriz
Melek sandığım şeytanın maskesi düşünce şaşkına döndüm	surpriz
Diziyi izlemiyorum, bu videoyu görünce hayret ettim rahatsız oldum. Merakla soruyorum genel olarak böyle şiddetçi erkeği sunan bi dizi mi?	surpriz
Aaa sevgilim gelmiş. Konuş sevgilim 	surpriz
Ananem bana sürpriz yaptı geçen hafta aldığı çorabın grisini alarak 	surpriz
Oha evde pijamalarla çalışıyodum misafirler geldi pastayla doğum günü sürprizi yapmışlar şoka uğradım gidiyorum 12de iki tane pasta kescem	surpriz
Bizden olmazdı zaten, olur gibi olmasına hala şaşkınım ben	surpriz
şu oğuzhanı ilk onbirde inatla oynatan hocaya inanmıyorum artık.	surpriz
ne yazacağımı şaşırdım mk :) bildirime bak	surpriz
İlk defa bugün twitter donmuyor bende hayret 	surpriz
O değilde geçen akşam kınada peşimde dört dönen çocuk instagramdan beni bulup takip etmiş. Azme bakın hayret ettim ??	surpriz
Size şimdi hayret edici birşey söylücem çoğu şehre kara kış gelmişken biz burdur da hala kısa kollu giyiyoruz	surpriz
vallahi cok şaşkınlık verici ya şaşırdım :(	surpriz
Hayret gündemi değiştirecek bir şey çıkarmadılar daha.	surpriz
Ama galiba tüm bu olanlara dayanamam ama hazırım cümlesi gerçekleşti ben neye inanacağımı şaşırdım be.	surpriz
Annem bornozlarımızı ütülüyormuş şu an şoka uğradım	surpriz
Şaka yapıyorsun herhalde. Hangi mahkemede... .	surpriz
Faul var tabi konuşmaya değmez ama tetikçi cüneyt nasıl iptal etti şaşkınlık verici	surpriz
Kaynanam seviyor mu ne sürpriz yaptım hazırlığa denk geldim	surpriz
Biraz önce karpuzun sebze oldugunu öğrendim, hayretler içindeyim.	surpriz
O tamponu boyayan ustayı arayıp sorduğumda aaa sen farkettin mi diyor. nasıl farketmeyim tampon pembe araba bordo ?? 	surpriz
Allah uyuz versin de tırnak vermesin nasıl bir bedduadır ya şaştım kaldım	surpriz
Vay arkadaş hayata bakışım değişti. Ben şok ben iptal. Ben şey yapayım o zaman erzuruma geleyim bir ara.	surpriz
Bu kimya deneyi sonucunda, meydan çıkan görüntü çok şaşırtıcı... 	surpriz
Ali koçun konuşmasını nasıl veriyor fb tv hayret ettim	surpriz
Olmasan da oluyor. Şaşkınlık verici ama oluyor.	surpriz
Annem bana çay getirdi şu an şoktayım içsem mi içmesem mi bilemedim	surpriz
mucize eseri alarm falan çalmadan kalktım hala şoktayım	surpriz
İnsan hala bazı şeylere hayret ediyor	surpriz
=======
Delireceğim kafayı yiyeceğim sus beynim sus	kızgın
Final haftamda çok agresifim uçan kusla bile kavga ediyorum	kızgın
Ne demek yürürken mesaj atamıyorum mal mısın	kızgın
Evet sizi bırakıp Mobile legends oynayıp küfür edeceğim ama geri gelicem	kızgın
Eğer sprite içersen seninde paran gidecek mal mısın ya	kızgın
Kaptana kızgınım, insan bizi de çağırır	kızgın
Ağız şapırdatmak kadar sinir bozucu birşey yoktur herhalde.	kızgın
Sevgilimi çok özledim bana ters yapan olursa başının üstünde yeri var agresifim kompleksliyim şu an	kızgın
hay sikeyim seni gibi yorumcuyu bir de buna para veriyorlar ya sinir oluyorum lan 	kızgın
Hakaret ediyormuşum sinirinden geçilmiyor. Sen bana ne yaptın farkında mısın!	kızgın
İstediğin insanla mutlu ol, o yüzün hep gülsün ama lütfen artık defolup git şu aklımdan	kızgın
Nasıl domuz eti yersin sen ya sinirden küplere bindim uyuyamıyorum ! 	kızgın
Bana kısa cevap vermeyin çok sinir oluyorum ya	kızgın
Ben takip atıyorum siz GT atmıyorsunuz ve ben size sövüyorum	kızgın
Toplumun her kesiminden insana öfkeliyim	kızgın
Site toplantısına oğlumu yolladım sinir küpü olmuş bir şekilde geldi 	kızgın
Elektrikler gitti sıçıcam böyle işe resmen izlemiyim diye amk kudurdum sinirden 	kızgın
Kasım ayında sivrisinek mi olur ya kafayı yiyeceğim artık	kızgın
kısa kısa cevaplar vericeksen niye yazıyorsun gerizekalı	kızgın
çok agresif hissediyorum şu an yani bilmiyorum belki de çişim olduğundandır	kızgın
Çok fena iftira atıldı üstüme şu an çok sinirliyim	kızgın
Ben bu kızı unutalı sene geçti neden gördüm ki yine? Sinirlendim	kızgın
Sol şeritte 90 lik yolda 50 sürüyor gerizekalı. Allah'ım sakin olamıyorum böylelerini görünce	kızgın
Birşey anlatırken ben demiştim ama diyip duranlara sinir oluyorum. Ama aynı şey karşı tarafa olsa hiç çekinmem söylerim.	kızgın
2-3 ay yazmıyor. Sonra geliyor en şerefsiz haliyle hiçbir şey olmamış gibi kafa karıştırıyor. Ya bir defol git.	kızgın
Nefretimiz elektriğe dönüştürülebilseydi bütün dünyayı aydınlatmaya yeterdi 	kızgın
Şimdi burda bi küfür edeceğim 150 kişi takipten çıkacak o kadar doluyum	kızgın
Allah boy veriyor tip veriyor ama zekadan kısıyor işte nabalım gerizekalı	kızgın
Saatlerdir yataktan kalkıp duş alayım diye uğraşıyorum, kalkamıyorum delireceğim	kızgın
Kramp senden nefret ediyorum	kızgın
Öyle sinirliyim ki araç sürmeme izin vermiyorlar. Anahtar saklamak nedir?!	kızgın
Sabah sabah aklımda ne işin var ya bir defol git...	kızgın
Seni ilk bakışta gerizekalı felan sandım cidden gerizekalıymışsın	kızgın
Yeter artık bir karadenizliyle evlendirip dağlara salın beni çıldıracağım yeter	kızgın
Elit bir semtte oturmasam sokağa çıkıp bağıra bağıra küfür edeceğim sinirim bedenime sığmıyor..	kızgın
Germeyin oğlum beni sinirliyim agresifim bak	kızgın
artık o kadar herşeye sinirleniyorum ki kendi saçımı başımı yolmamak için kendimi zor tutuyorum	kızgın
sürekli sinirleniyorum artık akışına bıraktım neye sinirlendiğimi falan bilmiyorum	kızgın
Git gide tahammülsüz bir insan oluyorum sürekli sinirliyim galiba ruh hastası oluyorum yavaştan	kızgın
Çok sinirliyim ama sebebini bilmiyorum	kızgın
Ateist gibi davranma mal kendine gel	kızgın
Biz bu trabzona nasıl yenildik düşündükçe sövüyorum sövdükçe sövüyorum yok böyle birşey arkadaş ya	kızgın
Herkes birbirlerinden nefret ediyor ama herkes birbirleriyle samimi.	kızgın
Herkes bir yerlere çekip gitmek istiyor amk tutan mı var lan diye bağıracağım sonunda	kızgın
O kadar sinirleniyorum ki kendime bile niye bu kadar sinirlendiğim için sinirleniyorum	kızgın
Her şeye öfkeliyim, başım da ince ince ağrıyor	kızgın
Lütfen hayatımda ki herşey ve herkes net olsun, belirsizlikten nefret ediyorum. Düşünmekten kafayı yiyeceğim	kızgın
Bazı tarihlere çok kızgınım, takvim yapraklarıyla anlaşamıyorum	kızgın
kuzenime ödev yaptırıyorum birazdan çıldıracağım sanırım	kızgın
Öyle kızgınım ki -40`ta kalsam soğumam..	kızgın
Mesaj atınca sinirden küplere bindim	kızgın
Gripli ve öfkeliyim bu yüzden hepinizi karantinaya alıyorum	kızgın
5gb dün geceden bugüne bitti turkcelli allah alsın yani şu an çok kızgınım	kızgın
Yemin ederim sizinle uğraşamam benimle muhatap olmayın	kızgın
Ay yemin ediyorum başıma ağrı girdi, sinirden köpürdüm bir annenin çaresizliğini görünce!	kızgın
Her şeyin rahatsız ediyor beni nolur defolup git artık nereye gidiyorsan	kızgın
Banko şampiyon olacağımız turnuvada sakatlık ve yedeğimiz yok diye diskalifiye olduk sinirden kafayı yiyeceğim	kızgın
Kendini kime kanıtlamaya çalışıyorsun mal mısın	kızgın
Sakin kalmaya çalıştıkça günden güne artan öfkemden nefret ediyorum.	kızgın
İnternetin kotası doldu çok öfkeliyim	kızgın
Kasıtlı yapılan bir şey özürle düzeltilemez, defol ülkemden	kızgın
En çok toprağa kızgınım ve en çok toprağı kıskanırım	kızgın
Netimi saçma sapan şeylere harcıyorum	kızgın
Sen gerizekalının tekisin anlatsam da anlayamazsın 	kızgın
Herkes gergin şu an anasayfada herkes sinir küpü olmuş	kızgın
Ben annemden boşuna mı yemek yapmayı öğrendim gerizekalı	kızgın
Kimse sana güvenmiyor. Herkes senden nefret ediyor. Yeryüzündeki hastalıksın sen.	kızgın
Dişini fırçalamayan tırnak bakım saç bakımı yapmayan ve kokan insanlardan nefret ediyorum.	kızgın
Millet ne der' diye düşünenlerden nefret ediyorum 	kızgın
Uykumu almadığım zaman kendimi çok agresif hissediyorum.	kızgın
Zeki insanlar daha çabuk sinirlenir diye okudum bir yerde ve ne oldu bilmiyorum bir anda küplere bindim.	kızgın
Çıkıp bağıra bağıra küfür edeceğim şimdi tutamıyorum artık kendimi	kızgın
Antidepresan kullanmaya başladığımdan beri daha da agresif oldum bu işte bi terslik var	kızgın
Hayata karşı öfkeli değilim sana öfkeliyim bebeğim.	kızgın
Sinir küpü olduğum tek kelimelik mesajdan anlaşılıyor 	kızgın
birşey söyleyeceğim diyip 10 saat sonra yazanlara sinir oluyorum	kızgın
Benimle ilgili yorum yapan saçma sapan insanlara hayatımı açıp baksana sen neresindesin diye göstermek istiyorum.	kızgın
Bir daha arap görürsem haydi yallah arabistana diye bağıracağım	kızgın
Sinir küpüyüm bulaşanın canını fena yakarım	kızgın
Tivitlerimi görmesi gereken görmüyor delireceğim	kızgın
Susarak asil olmak bana göre değil illa küfür edeceğim	kızgın
Evin duvarından tut yerdeki halıya kadar öfkeliyim kapı tokatlıcam birazdan	kızgın
Bir yaş daha... Ne çabuk geçiyor yıllar kafayı yiyeceğim	kızgın
Sizi zerre umursamayan insanlar için deli gibi üzülüyorsunuz. mal mısınız?	kızgın
Sabaha kadar cs go atıp ruslara küfür edicem	kızgın
Mal mısın madem tekrar engelleyeceksin neden kaldırıp mesaj atıyorsun	kızgın
Ya bu Ayşe mi Banu mu kaç doğumluydu bu kız ya delireceğim	kızgın
Verdiğim değere karşılık alamayınca değil, nankörlük edilince sinir oluyorum	kızgın
Saçma sapan şeylerle oyalanıyoruz. Hiçbir şey gerçek değil. Biz de	kızgın
Hala dört bin gösteriyor kafayı yiyeceğim	kızgın
Bu aralar agresifim kompleksliyim ama perdelerimi kaldırdığımda kedi gibi bir insanım	kızgın
Yine güzel bir çay içemedim, agresifim	kızgın
Sebepsiz yere arıyorum çalarken açarsa ne diyiyeceğim diye düşünüyorum açmayınca da sinirleniyorum	kızgın
Okuldan ciddi anlamda nefret ediyorum eskiden arkadaş var en azından derdim şimdi onlar da yok	kızgın
Bugün var ya çok agresifim, sağa sola çatıyorum az önce virajdan dönemeyen arabaya saydım sövdüm gömdüm	kızgın
Allah'ım çıldıracağım. Yemin ederim çıldıracağım sinirimden. Bir yerden de çıkaramıyorum cam çerçeve indireceğim şimdi ne varsa.	kızgın
Nefretimiz elektriğe dönüştürülebilseydi bütün dünyayı aydınlatmaya yeterdi 	kızgın
Bir ara çok sinirleniyorum sonra geçiyor sinirim	kızgın
Elektrikler yok delireceğim şarjım olmuş %10	kızgın
İstifa etme kovdur kendini mal mısın	kızgın
Google'un her soruya bir cevabı var çok sinir bozucu ya	kızgın
Sinirlenince gözlerimin dolmasından nefret ediyorum	kızgın
Derste aniden kalkıp allahu ekber diye bağıracağım vallahi yeter	kızgın
Doğal olmak basit bir tavırdır ve bildiğin en sinir bozucu tavır... 	kızgın
Tam rüyanın ortasında annem uyandırdı. Agresifim bugün	kızgın
Allah belamı versin ki günün üç saati keyfim yerindeyse geri kalan yirmi bir saat sinir küpü oluyorum	kızgın
Bir şeye sinirliyim ama ne olduğunu ben de bilmiyorum	kızgın
Havaya küfür edicem şimdi ya kış mısın yaz mısın aq bir karar ver	kızgın
eğitim sistemi cidden berbat saçma sapan gerizekalı bir sistem 	kızgın
Madem durmak istemiyorsun hiç durmadan defolup git bu ülkeden mesela	kızgın
Okula gitmek istemiyorum diye avazım çıktığı kadar bağıracağım	kızgın
Yahu şu 7 rakamındaki sır ne kafayı yiyeceğim niye 7 ya	kızgın
bir yandan uzunu izlediğim için agresif hissediyorum kendimi. birazdan umarsızca koşmaya çıkacağım sinirimi atmak için.	kızgın
Sinirimi birilerinden çıkarmam lazım yoksa delireceğim	kızgın
Bu ara herkese sinir oluyorum ya dayak yiyeceğim yada dayak atıcam başka açıklaması yok	kızgın
Erken uyandığım için kızgınım kendime. Bok vardı çünkü.	kızgın
Bir gün her şeyi terkedip deniz kenarında dans ede ede tertemiz delireceğim	kızgın
Gerizekalı gibi iş yapıyosunuz sonra profesyonellikten felan bahsediyorsunuz. 	kızgın
Şu an sinirimden pcyi alıp camdan aşağı atmamak için kendimi zor tutuyorum	kızgın
Aziz kiraz ne ya saçma sapan insanları yutubır yapıyorsunuz	kızgın
O kadar öfkeliyim ki artık kelimelerim yetmiyor bunu atmaya içimden	kızgın
Meclise bak esenler arka mahallesi gibi bizi yöneten kitleye bak yumruklar küfürler kavgalar yazıklar olsun hepinize 	kızgın
Kimseye hayır diyememe huyumdan nefret ediyorum.. Ne gelse başıma bu yüzden geliyor.	kızgın
İnanılmaz agresif hissediyorum boş ve manasız bir öfke var içimde bulamıyorum sebebini yaşayıp geçirmiş olan dm 	kızgın
Uzun bir süre girmeyip tekrar online olunca tuhaf oluyormuş takipten çıkan herkese ana bacı sövüyorum 	kızgın
21 yaşındayım baştaki tivit silinmiş sinirliyim 	kızgın
Az önce sodayı açmaya çalışırken her yere döktüm sakar ve öfkeliyim şu an	kızgın
Şu an o kadar sinirliyim ki ilk gördüğüm insanı öldürebilirim	kızgın
Esra Erolu çileden çıkartan şalvarli gelin adayı kadar agresif hissediyorum	kızgın
Beyin bedava iken, gerizekalı olmak ciddi bir yetenek işidir... 	kızgın
Acıkınca sinirleniyorum bana hemen yemek getirin.	kızgın
Of ağzımdaki uyuşukluk geçmedi hala delireceğim	kızgın
Ya param yokken yapmayın şu indirimleri sinirleniyorum 	kızgın
Çok güzel küfürler biliyorum ama kadına yakışmıyor diyorlar.	kızgın
Şu an sokağa çıkıp sağda solda eyşana küfürler saçmak istiyorum sinirden delirdim resmen	kızgın
sinirliyim ve bu beni daha da çirkin yapıyor	kızgın
Yaşadığım sürece negredoya küfür edeceğim	kızgın
özelden arıyorsunuz niye konuşmuyorsunuz amk mal mısınız	kızgın
Bugün aşırı agresifim, sinirliyim, çıldırıyorum. Allahım 20 yaş sendromu mu bu help me ne olur	kızgın
Küfür eden kızlara itici diyenlere anlam veremiyorum, sinirlenince napsınlar örgü mü örsünler amk	kızgın
Ben mi herşeye çok kolay sinirleniyorum yoksa gerçekten insanlar çok mu sinir bozucu	kızgın
Şu instastory izleyenler neye göre sıralanıyor ya yemin ederim çıldıracağım	kızgın
Agresif oldum. Olur olmadık herşeye sinirlenir oldum	kızgın
Nasıl bir sinir küpüyüm şu an var ya bir dersi almam bir dk sürüyor	kızgın
Şu an öyle bir sinirliyim ki lan ne kadar saçma salak insanlar var	kızgın
Sinirlenince cümle kuramamaktan nefret ediyorum	kızgın
mesajıma cevap vermeyip tweet atan insanlara sinir oluyorum delireceğim bir gün	kızgın
Çok sinirliyim örtmene hastayım diyip gitmeyeceğim derse amk ben matemetik öğrenmek istemiyorum	kızgın
Şu an çok sinirleniyorum her gebze haremi gördükçe, daha ne kadar akraba olma arabası geçecek?	kızgın
Düşündükçe sinirleniyorum, sinirlendikçe düşünüyorum. Kısır döngü girdabındayım... 	kızgın
Yumurtanın sperme gittiği nerde görülmüş gerizekalı ben mi yazıcam.	kızgın
10 gündür çiğköfte yemiyorum delireceğim yakında	kızgın
İçim daraldı yine sinirlendim bak	kızgın
Sesin kulaklarımdan gitmiyor kafayı yiyeceğim.	kızgın
Gördükçe sinirlerim zıplıyor saçma sapan insanları ünlü etmeye bayılıyorsunuz	kızgın
Ya nasıl pislik arkadaşlara sahibim yemin ederim düşündükçe kafayı yiyeceğim	kızgın
Ne çok gerizekalı insan var bu sitede hepsi o kötü atlara binip defolup gitse keşke	kızgın
Abim öğretmen seni gerizekalı. Prim kasmak yerine bana sorsaydın söylerdim	kızgın
Ya bunların derdine ne mal mısın gerizekalı Hayır dedik ya ne orada burada yalan yanlış konuşuyorsun	kızgın
Radyo dinlerken sinir küpü oldum	kızgın
Sıkıldım yoruldum insanların ön plana çıkma istekleri istekleri çıkarları ... yıprandım	üzgün
Dgslilerin sorunu ne integral ne trigonometri.Şimdi sen kaç yıl daha okuyacaksın sorusu.Yoruldum anlatmaktan.	üzgün
Moralim o kadar bozuk ki Avrupa Yakası izleyip moralimi düzeltmeye çalışıyorum şu an	üzgün
Vedaları sevmiyorum, soguk oluyor, acı, mutsuz 	üzgün
Ağlamayla dolu saatler bunlar hep... 	üzgün
Moralim bozuk diye telefon aldım yine moralim düzelmedi. Uçurumdan atın beni ya	üzgün
Bende tükendim ziyadesiyle ama insanlar tarafından değil bizzat kendi tarafımdan	üzgün
Neden yorgunsun sorusuna cevap aramaktan ve bunu sormasınlar diye gülümsemekten yoruldum.	üzgün
İstemsiz moralim bozuk sanırım hoşlanmıştım	üzgün
Tuncelide helikopter kazasında kaybettiğimiz şehitlerimize Allahtan rahmet dilerim, Büyük acı Işıklar içinde yatsınlar Başımız sağolsun 	üzgün
Bilinmedik bir hüzün var içimde .. Bir gariplik.. Yalnızlık mı suçlu, gece mi ..?	üzgün
Cidden çok sıkıldım resmen rezillik yeter artık bıktım	üzgün
Böyle kepaze hayatı sürüklemekten yoruldum arkadaşlar	üzgün
O kadar mutsuzum ki nasıl anlatayım ki?	üzgün
bundan sonra kimseye ücretsiz arkadaşlık hizmeti vermiyorum çiçek gibi çocuğum yıprandım artık	üzgün
Hiç hissetmediğim kadar özgür hiç olmadığım kadar mutsuz hiç düşünemeyeceğim kadar umutsuzum	üzgün
Gratise girdim baba çok pişmanım	üzgün
Bugün birisi yüzüm olmasa yakışıklı olacağımı söyledi kırgınım	üzgün
Tatil bittiği için ilk hafta gitmemeyi düşünmeme rağmen hüzünlüyüm 	üzgün
Moralim bozuk. Canım sıkkın. Param yok. 	üzgün
aykut kocaman takımın başında haberiyle uyandım ya çok mutsuzum	üzgün
Artık kısa cevaplar ve terslemelerden çok sıkıldım sürekli aynı replikler boğuyor 	üzgün
İnsanların işi düşüklerinde aranan ve her işlerini çözen insan olmaktan bıktım, yoruldum artık... 	üzgün
İstanbul şartları olup bitenden daha fazla etkilenip üzülmeye elden bir şey gelmemesine ve mutsuzluğu katlamaya birebir 	üzgün
Gitmekten yoruldum, artık sadece bir kenarda oturup soluklanmak istiyorum.	üzgün
Yemin ederim yıldım, bıktım ya beni bir salın	üzgün
Hissediyor musun bilmiyorum ama çok özledim.	üzgün
Bıktım 2.438 takipçiden ya unf atın azalsın ya da bir şekilde artsın	üzgün
Sigaram bitti dışarda fırtınalı yağmur var ve ben kafamı duvara vura vura ağlıyorum.	üzgün
Ne zaman alışveriş diye çıksam birşey almadan geri dönüyorum çok mutsuzum 	üzgün
Ya artık evlende kurtulayım şu stalk işinden yeter bıktım	üzgün
20'lik dişim çıkıyor ağlamak üzereyim sürünüyorum	üzgün
hoca salda bir patlangaç yapıp geliverek bunaldım dertlendim gari	üzgün
İnanki ağlamadım hüzünlüyüm sadece 	üzgün
ben ağlamaya gidiyorum. 	üzgün
O kadar yoruldum ki herşeyden yanlış durakta indiğimi bile ana caddeye çıkınca anladım	üzgün
19 liralık para üstünü bozuk para olarak veren garanti atmye kırgınım	üzgün
Bir şey beklemiyormuş gibi yapıp içime dünya kadar umudu sığdırmaktan da yoruldum.	üzgün
Farkettim de son 5 gündür falan tweetlerimde vize kelimesi göze çarpıyor. Çok yıprandım.	üzgün
Özledim gökyüzü kadar uçsuz bucaksız	üzgün
Özlesem de özledim diyemiyeceğim kadar üzdüler beni. Bende susmayı öğrendim...	üzgün
Şu İstanbul’un insanı kadar menfaatçi insanlar görmedim ben Kıbrıs’ı özledim hocam	üzgün
Bu hava beni mutsuz olmaya zorluyor 	üzgün
Kuzenim trt cocuk dergisini alamadı diye ağlıyor keske benim de tek derdim bu olsa	üzgün
O kadar mutsuzum ki en fazla bu kadar mutsuz olunabilir	üzgün
odamda örümcek var çok fazla üzgünüm her yerim kaşınmaya başladı kocaman	üzgün
ölmüşüz ağlayanımız yok kokmuşuz tuzlayanımız yok 	üzgün
Yolda yürürken birden yere oturup tükendim yeter demek istiyorum	üzgün
Fena şekilde hüzünlüyüm, dışarıdayım ve kulaklığım yok. Bu hayattaki görevim bitmiştir.	üzgün
Ya bıktım ben bıktım insanların beni aptal yerine koymasından bıktım 	üzgün
Ben teen wolfu özledim ağlayacağım şimdi	üzgün
Türkiyede diziler neden 2 saat ya vallahi bezdim artık izlemiyorum alın dizinizi başınıza çalın	üzgün
Of bu sabah kimse mesaj atmamış günaydın falan filan diye, kırgınım	üzgün
Pişman değilim ama keşke daha iyi şartlar altında kendime yazık etseydim	üzgün
Doktora ilaçlarımı söylerken bile yoruluyorum. İçmesi ayrı yutmadı ayrı oy tükendim	üzgün
Önce biraz zor gelecek ama alışacaksın üzülmeye 	üzgün
Hayat beni neden yıpratıyorsun 	üzgün
Sürekli, yaptıklarım için pişman değilim diyorum ama aslında köpek gibi pişmanım herşey için. Allah belamı verecek.	üzgün
Anlamak istemeyen anlamak isteyenin vaktini çalmasa keşke 	üzgün
aşkım çok kötüyüm hemen beni istemeye gelebilir misiniz.	üzgün
İrmik helvası yaptım ve öküz gibi yedim, pişmanım.	üzgün
Ben artık kendimi savunmaktan yoruldum demekten bıkmadınız mı 	üzgün
Mutsuz yalnız ve fakirim. Uf ya. 	üzgün
İçim yanıyor ağlıyorum kahr oluyorum	üzgün
Bir umuda sarılarak yaşıyorum ama aslında çok umutsuzum.	üzgün
Keşke akrabaları kendimiz seçebilsek muhteşem bir sülale kadrosu var kafamda 	üzgün
her gecenin göğsünde ayrı bir hüzün yatar; ah ne uzundur kuşatılanın gecesi, sarmalayamadığından... 	üzgün
Diyelim ki ben bu gece çok kötüyüm. Nasıl teselli edersiniz	üzgün
İstanbul şartları olup bitenden daha fazla etkilenip üzülmeye elden bir şey gelmemesine ve mutsuzluğu katlamaya birebir 	üzgün
O kadar moralim bozuk ki zorla bile gülemiyorum	üzgün
Ben gözlerimi bir sana açmışken senin bakar gibi yapıp dünyayı seyretmene kırgınım.	üzgün
Yemin ederim hayatımın en umutsuz dönemlerindeyim ya bir şeylere heves etmeye bile halim kalmadı.	üzgün
O günden beri, evet seni sevdiğim, unutmak istediğim o günden beri çok mutsuzum..	üzgün
Hayat bilgisi izleyip ağlıyorum. Psikolojimin farkında mısınız?	üzgün
Trabzondayken evde olduğum her saat için hüzünlüyüm	üzgün
Her akşam aynı hüzün, yol gözler iki gözüm...  	üzgün
Basketbolu çok özledim :( 	üzgün
Böyle denk gelişler olmasa keşke	üzgün
Hafız beni ağlatma zaten üzgünüm	üzgün
Eski fotoğraflara baktım evrim geçirmişim kimler varmış kimler yok olmuş hüzün kapladı içimi..	üzgün
Pijamamın cebi ve yatağımın yanında üçlü priz olmasına rağmen mutsuzum yuh	üzgün
Erkek arkadaşıma 60 liraya kazak aldım . pişmanım ... 	üzgün
Nefes alamıyorsam demek.... bunaldım.....	üzgün
Hayattan vazgeçemeyecek kadar korkak, hayata tutunamayacak kadar umutsuzum	üzgün
Üzgünüm, mutsuzum hayatınız yolunda gitmediğinde ne yaparsınız...	üzgün
küfür olduğu için üzgünüm yakışmadı bana	üzgün
Dünyanın en sıkıntılı durumu metroda çişinin gelmesi ben ağlıyorum şahsen başka çözümüm yok	üzgün
Michaelın kaş piercingini özledim bir de renkli saçlarını	üzgün
Ne zamandır grip olmuyorum ne kötü bişeydir bu ya berbat hissediyorum kolumu zor kaldırıyorum ya! Ve gözlerim doluyor 	üzgün
Kendimi birilerine anlatmaktan o kadar sıkıldım ki artık soranlara boş adam imajı çiziyorum.	üzgün
Yavşağın biri son ses Azer Bülbül açmış durduk yere dertlendim	üzgün
Batak oynayan gelsin sıkıldım anam	üzgün
Belki bizim kaderimiz mutsuz olmaktı 	üzgün
Yakın geleceği merak etmekten yoruldum bu bir hafta geçmez artık	üzgün
Bugün bu hayat beni çok yordu ya yemin ederim yıprandım fanusta yaşıyorum	üzgün
Kankam nöbete gitti bir miktar hüzünlüyüm ama yarın görürüm	üzgün
Beyin henüz transfer edilemiyor sizin için üzgünüm	üzgün
Şu okulda bir şeyler kaybetmekten sıkıldım artık Okul okul değil kara delik sanki 	üzgün
Yıprandım ya daha ne kadar sömürebilirsiniz acaba	üzgün
Afrin'de 5 Canımız şehit oldu çok üzgünüm..Allah'tan rahmet, yakınlarına sabır ve başsağlığı dilerim...	üzgün
Kendimi güçlü falan hissetmiyorum tükendim artık	üzgün
kendimi üzgün hissediyorum, sanki tüm dünya’ya kırgınım.	üzgün
Emlağım olsada emlak vergisi ödesem keşke ... 	üzgün
yolda yürürken birden yere oturup tükendim yeter demek istiyorum	üzgün
Yoruldum. Yıprandım. Tükendim. Ben bu sefer harbi bittim.	üzgün
Çok yoruldum, hüzün uyutmuyor. 	üzgün
Git buralardan herkesi arkanda bırak git mutsuzluğunu al yanına gözyaşlarını topla git 	üzgün
Umut bağlamaktan sıkıldım ve her defasında kırılmış bir kalp	üzgün
Aklıma Fernando geldi, moralim bozuk	üzgün
Bilinmedik bir hüzün var içimde, bir gariplik. Anladım ki, ya ben fazlayım bu şehirde yada biri eksik.	üzgün
Çiçeklerin boynunu bükmesine bile üzülüyorum kış gelmesin 	üzgün
çok sıkıldım ya siz sıkılmadınız mı gençler sanki saat geçmiyor	üzgün
Moralim bozuk ve kalbim hiç olmadığı kadar kırık	üzgün
O kadar yorgunum o kadar tükendim ki olmayan şeyler duyup görüyorum	üzgün
Bir hayli yorulmuştum üstüne bir de yıprandım...	üzgün
Fiziğin yeniden yeniden yeniden allah belasını versin ya yeter ya bıktım 	üzgün
Ben neden bu yaşta hayattan bezdim ya	üzgün
Üzülüyorum sıkılıyorum kötüyüm	üzgün
Saat 6 dan beri uyuyorum. Ama hala mutsuzum.	üzgün
Twit atarken az samimi olun yapmacık şeyler okumaktan sıkıldım artık	üzgün
O kadar mutsuzum ki yatağıma yatıp şarkı dinleyerek uykuya dalmak istiyorum ve sonsuza kadar o yataktan çıkmamakta tek hayalim	üzgün
Bıktım artık sınav sonunda doğrularımı saymaktan artık yanlışlarımı saymak istiyorum :((	üzgün
sabah şekeri olamayacak bu twitler üzgünüm. zaten dünya böyle bir yer.	üzgün
Kaybolmuş gibiyim, nereden başlayacağımı bulamıyorum. Sanırım tükendim.....	üzgün
Bu hafta ben. İlk defa vize haftasında bu kadar yıprandım	üzgün
yıldım, yoruldum, tükendim, bunaldım, bıktım, bezdim, sıkıldım, tahammülsüzleştim, bunların tüm sebebi VİZELER	üzgün
En ufak abartı yok bu diyeceğimde. Bazı günleri, bazı insanları ve bazı anları özlemekten soldum, tükendim, halim kalmadı.	üzgün
Üzgünüm size çok destek olamıyorum hafta sonu malum misafirlik 	üzgün
Moralim bozuk değil ama iyi de değil, bir derdim yok ama varmış gibi, kötü değilim ama iyi de değilim. Falan filan... .	üzgün
Yine 10 lu halleyi bitirecek kadar üzgünüm	üzgün
Kulaklığımı yolda düşürmüşüm çok üzgünüm..	üzgün
Keşke hayal kırıklığı zayıflatsaydı, ne güzel şimdiye kadar yok olmuştum	üzgün
Biri benim yerime yaşayabilir mi benim halim kalmadı da	üzgün
Üzgünüm ve artık bunun benimle de alakası kalmadı	üzgün
Yorgun mutsuz ve umutsuzum	üzgün
Hayat artık beni diskalifiye et gözünü seveyim tükendim	üzgün
Sen benden gittin gideli mutsuzum :(	üzgün
Tae fancafe attı hemde fotoğraflı ama finger heart yapmış, ağlıyorum	üzgün
kuş banyoya girmiş çıkmıyor giremiyorum ben de o yüzden ağlayacağım	üzgün
Yine herkes Maraş'a gittiği için biraz mutsuzum	üzgün
orta okul günlerimi özledim ben keşke geri dönebilsek	üzgün
Bugün yapılan hain saldırıda hayatını kaybeden vatandaşlarımıza Allahtan rahmet yakınlarına başsağlığı yaralılara da acil şifalar diliyorum 	üzgün
o kadar mutsuzum ki artık kalbim fiziksel mi duygusal mı acıyor anlayamıyorum	üzgün
Özledim diyorsun mektubunda. Sadece kuru bir özledim mi yazdı yanık yüreğin. 	üzgün
Markete gidip dünyayı alıp evde dizi izleyerek ağlayacağım çünkü yarın okullar açılıyor	üzgün
Çok fena stalka düştüm mutsuzum	üzgün
Yine bir dönüş vakti Ve içimde bir dem hüzün..	üzgün
Her sene kurtulcam bu şehirden demekten ben yoruldum. Bir sal artık beni ya. Bu son kış olsun yeter.	üzgün
Hayatta çok üzüldüm ağladım, çok yıprandım ama yaptığım hiçbir şeyden bir deneyim diye aldığım farklı rimel kadar pişman olmadım.	üzgün
Üzüntüden, ağlamaktan kirpiklerim dökülüyor çok güzel şimdi de onları nasıl uzatacağım diye ağlıyorum.	üzgün
Bugün çok mutsuzum. Hava da rüzgarlı. Rüzgarlı havalarda ben hep mutsuz olurum zaten.	üzgün
Bu aralar bir melankoli bir hüzün kapladı içimi Sebebi koparılan çiçekler	üzgün
Artık İngilizce dersler çalışmaktan bıktım.. Bir an önce vizeler bitse de Portekizce, Almanca ve İspanyolca çalışmaya geri dönsem	üzgün
Darılma bana çok sıkıldım artık	üzgün
Yazılılar her şeyi engelliyor bıktım bıktım stresinden de kendisinden de	üzgün
Kendimden taşınmak istiyorum artık çok yıprandım yeni sıfır bir ben lazım bana.	üzgün
Acil servisi o kadar özledim ki ağlamak istiyorum	üzgün
Arkadaşlarla yazın kaçmak için tek çarem kolumu kırıp rapor almak üzgünüm	üzgün
Neyseki şu ağlatan diziler varda ağladığımızda neden diye sorulmuyor	üzgün
Çok yoruldum artık, Her şeyden uzaklaşmak istiyorum.	üzgün
Şu an dışardan korkutucu sesler geliyor sanki kıyamet	korku
Ölüm kötü insanlar için çok korkunç bir bekleyiştir. 	korku
Türkiye'de çocuk olmanın bedeli korkunç... Bebek ölüm hızı binde 12... 2016'da zorla... 	korku
Beni pijamalı evden çıkartıp markete gönderen hayat karşıma tarkan'ı çıkartacak diye ödüm koptu	korku
Oha ödüm koptu o nasıl şiddetli gök gürlemesiysi o öyle	korku
1 haftadır her gün kabus görüyorum yeter Allah'ım ne istiyorsun benden	korku
Efes'in 16 basketin ancak altısını asist üzerinden bulabilmesi biraz endişe verici. Guardlar toplam 1 asist.	korku
Kendimi burada bulmaktan korkuyorum 	korku
Yastığımın altından siri konuştu çok korktum be	korku
Yani irkilmeyene kadar izleme kararı almıştım, ses açıkken her defasında irkildim.	korku
çok korktuk ya of çok korkuyorum jackson gelip engel olucak diye ellen'a da gelir falan üf	korku
Yaşarsa konuşma ihtimali çok yüksek onun icin daha endişe verici, ölürse sorun ortadan kalkar!	korku
nehir değil okyanus ve sadece yüzeyi bulanık, derinlerinde ürkütücü bir duruluk mevcut.	korku
Demin deprem olduğunu sandım ödüm koptu ellerim çok titriyor korkudan ya	korku
Hayatımın ilk travması çok küçükken evde tek başıma korku filmi izlememdi	korku
Elektrik gidince İdil sokağı. Böyle bir karanlıkta okula gitmek korkutucu oldu. 	korku
Ben bugün seni rüyam da ölü olarak gördüm çok korktum çocuk allah korusun	korku
Çok korktum :(( hayatım gözümün önünden film şeridi gibi geçti	korku
kuş fobim var ama evde kuş yaşıyor?	korku
Gecenin bu saatinde hemcinsimden bu mesajı aldım, ciddi anlamda ürktüm, bu mesajı başka kişiler tarafından neden almıyorum Allah'ım? 	korku
İnsanın aciz olduğunu ara ara Rabbimin hatırlatması... ürkütücü bir manzara. 	korku
Korkunç be hareketlere bak ürktüm şahsen	korku
geçmişe dönüp bakmak dahi istemiyorum çünkü sen varsın, gülüyorsun ve yine yeni yeniden severim diye korkuyorum	korku
Bazı oteller lüks ve konforlu olması ile meşhurdur, bazıları ise ürkütücü olmalarıyla. 	korku
Tekirdağ’da trafik kazası : 1 ölü, 3 yaralı 	korku
Garezi izlediğim güne lanet olsun korkunçtu 	korku
Ya intihar etmiş ya of kabus gibi	korku
Şu an bile irkildim bu film hayatımı kaydırdı bilimkurguya düşman etti 	korku
Dow Jones herkesi yeterince korkuttu. Biraz yatay takılıp sonra yükselebilirsin mr. kovboy	korku
Spagetti hariç diğer makarna şekillerine karşı fobim var.	korku
Gökselle ortak noktamız varmış, ikimizde gök gürültüsü korkuyoruz...	korku
Kabus da rüya da aynı ikisi de geçiyor ölüm gibi vakit gibi	korku
Manyetik alan fobim var artık	korku
Bu tarz sessiz sakin havalardan nedense korkuyorum fırtına öncesi sessizlik gibi 	korku
kız bana squat mı yapıyorsun dedi korktum nerelerimi dikizliyon sen	korku
Sevenler Ölüme bile birlikte yürürler, çünkü ölüm bile ayrılıktan daha korkunç değildir.	korku
birinin telefonu çalınca neden ben geriliyorum acaba lütfen herkes sessize alsın ben korkuyorum	korku
Matçıya kısık sesle sus dedim hoca duydu tamam dedi amk sikecek diye çok korktum	korku
Payitaht İstanbul daha ürkütücü ama Dünya için ;)	korku
Az önce BlackPink house'un üzerine düşüyordum çok korkutucuydu	korku
Bir korku filmi izleyim de korkudan altıma sıçıp gece uyuyamayayım Allah'ım ne kadar da çılgınım	korku
Aklımı kaybetmekten değil de bulmaktan çok korkuyorum...	korku
Korku çok acı kabus gibi Yazamayanları anlayabiliyoruz	korku
Böceklere karşı fobim var diye habire onlarla karşılaşmaktan BIK-TIM	korku
Soy ağacıma baktım resmen Ortacalıymışız kabus gibi bunu nasıl sildirebiliyoruz	korku
Eğer yanıtlarım seni korkutuyorsa, korkutucu sorular sormaktan vazgeçmelisin.	korku
Yalnız her ikisinin de içinde gizliden gizliye büyüyen bir korku vardı: Bir gün gelip ayrılmak korkusu.	korku
Fernando ikinci sarıyı görecek diye ödüm koptu	korku
Korkuyorum cesaretim kayıp 	korku
Göğsü öne verip direksiyona yapışmakta istemezsin inşallah endişelendim..	korku
Zaman çok korkutucu bir kavram	korku
hoca peltek bu kez derken buket anladım irkildim kadın adımı bile bilmiyor	korku
Arkadaşlar her an birbirimizin ölüm haberini alabiliriz sizce de bu çok korkunç değil mi	korku
Bir rüya gördüm çok korkunçtu.	korku
Bunca patlama ve kan revanın ardından böylesi bir yağmurun İstanbul'u yıkaması çok ürkütücü değil mi? Yeryüzü hiç durma ölüyor ve diriliyor.	korku
Kaybolmuş corabın bulunamayan teki gibiyim . Hadi çıkarın artık beni buradan , çok soğuk ... korkuyorum	korku
Çok ürkütücü konuşmuş, kuş taraftarı..	korku
Allah'ım öyle korktum ki.. kalbim sıkışıyor.. Kendine çok dikkat et 	korku
Dün komple rüya olsaydı kocaman bir kabus gibi hatırlasaydım ..!!!!	korku
Yere çakılana kadar düşüşünü uçuş sanmak ne korkunç bir imtihan.	korku
İçimde biriken hislerin birdenbire patlayarak, beni zerreler halinde dağıtacağından korkuyorum.. 	korku
Ay Onur beey sizi o kadar iyi anlıyorum ki benim de düdüklü tencere fobim var	korku
Sabahın bu saatine kadar kaç korku filmi bitirdim hepsi kabus olacak, uyudu.	korku
Saçımdaki lastik tokanın kopmasıyla irkildim, vallahi çok korkakmışım	korku
Durduk yere endişelendim şu an.	korku
patlama sonrası çok fazla ölü var 	korku
Bu cümle beynime kabus gibi çöktü uyuyamıyorum.. 	korku
Hemen dibimde patlama oldu ve asıl ürkütücü olan, uzakta da olsa korkulacak şey dibimde olunca bile sıradan gelmeye başladı.	korku
Stockholm'de bir kadın ölü bulundu	korku
Bu nasıl bir havadır be. Kapkaranlık uu dışarı çıkınca resmen ürktüm	korku
Son görülme saatin endişe verici rakamlara ulaştı.	korku
Sana bir şey olacak diye o kadar korkuyorum ki gözlerim hep biraz ıslak	korku
Dünyanın en saçma rüyasını gördüm ama çok korkunçtu	korku
4 saat uyudum. Hollywoodun filmleri kıskandıracak bir kabus gördüm. Biraz korktum yani.	korku
Böyle rüya mı olur kabus gibiydi resmen	korku
Bunlar bizide yakacak ondan korkuyorum	korku
Söz de uyuyacaktım yine uykum kaçtı ürkütücü bir foto	korku
Sonunu bilen kelebek kadar endişeliyim... 	korku
Hasta olunca çocuklaştığımdan mı, ilaçların etkisinden mi bilmem ama balkonda uçuşan çarşafları hayalet sanıp ürktüm az önce	korku
Ne yani, böylesine korkunç bir dünyanın birde cehennemi mi var?	korku
Bir toplumun kötüde ve kötülükte birleşmesi ürkütücü.	korku
Sizinle aynı havayı almaktan... Gerçekten irkildim.	korku
Arabalarınızın koltuklarına maske koymayın sabah sabah ödüm koptu	korku
Kedilerin Diğer Hayvanlardan Daha Korkutucu Olduğu Anlar 	korku
Akıllara zarar böcek fobim var.. Öyle ki kalp atışlarımın hızı değişiyor..	korku
Sayenizde öğrendik; zehirli olmasa da görüntüsü ürkütücü... 	korku
hava soğuk diye çamaşırları evin içine astık. ödüm koptu pelerinli bir şey geziyor evde sandım bornozmuş	korku
Kararlılığınıza hayranım. Öyle ki, dünyayı yerle bir etmenizden korkuyorum.	korku
Ölmekten korkmuyorum ama sevilmeden ölmek ürkütücü	korku
Korkuyorum, bir gün etrafıma ördüğüm duvarların altında kalacağım diye	korku
Lütfen arkadaşlar imkanı olan ulaşsın çok endişelendim ben de	korku
Benim çok oluyor bir anda nefesim kesiliyor sanki ölüm anını yaşıyorum çok korkunç 	korku
Geçen hafta peşpeşe 3 gün kabus gördüm şükür ki balık hafızalıyım içeriğini hatırlamıyorum ama içimde bir şeylere karşı korku hissi var	korku
her gün başkalarının yerine utanmaktan utanmaz arlanmaz bir adam olup çıkacağım diye korkuyorum... 	korku
Uçaktan inince herkesin önüne geçmek gibi bir hata yaptım arkamda 100 kişi var yanlış yöne gideceğim diye ödüm koptu	korku
Anla ben büyük harflerden ürktüm	korku
Makarna yapmaya çalışırken evi yakıyordum amk ödüm koptu nasıl bir modelim anlamadım gitti	korku
Twittera da story özelliği gelecek diye çok korkuyorum	korku
Havai fişek fabrikasında patlama: 2 ölü	korku
Kardeşim elinde iğneyle kapıda bekliyormuş, korku filmi gibi ev	korku
Sabunlanan fare çok ürkütücü değil mi?	korku
Dünyanın en kötü rüyasını gördüm pompalı tüfekle annemi babamı ablamı vurduktan sonra intihar ettim aşırı korkunçtu	korku
Uzun süren aralar endişe verici.	korku
İstikrarsızlık giderek yayılıyor olması endişe verici. 	korku
Şarjım 1 di ekran kapanınca telefon kapandı sandım ödüm koptu	korku
Bu yeni kuş ne biçim suratıma atlıyor ödüm koptu resmen	korku
Candy crush oynarken zamanı ileri aldığımda mı aramış acaba ya ödüm koptu 	korku
Gözleri keskin, gözleri keskin, gözleri keskin bir tren sesi kadar korkutucuydu..	korku
ya benim yaşlı amcalara teyzelere fobim var galiba korkutuyorlar	korku
korkuyorum titriyorum üşüyorum	korku
Patlama çok büyük... ürkütücü rakamlar var. Allah korusun Yarabbi :(	korku
Dünya daha korkutucu bir hal aldıkça sanat da daha soyut hale geliyor.	korku
Otobüsteyim yanımdaki kadın müge anlı izleyip çay içiyor bazen de YUH cani şerefsiz diye tepkiler veriyor ürktüm	korku
Başınıza bir hal geldi diye çok endişelendim.	korku
Kabus gibi bir günün içindeyim ve bitmiyor.	korku
Yalnızlığın korkunçtu bahanesi. Her nefes alışında cigerine batıyor, battıkça alıştırıyor ve aynı yerden tekrar tekrar kanatıyordu. 	korku
E bende az psikopat değilmişim korktum 	korku
Samuru ödüm koptu böbreklerimi bıraktım resmen	korku
Volkswagen’in maymunlar ve insanlar üstünde yaptığı korkunç deneyler, film senaryosu gibi ama maalesef gerçek. 	korku
Ünlülere mention attığım korkunç dönem. Üç kişiye attım ama korkunçtu yine de. 	korku
Sonra durdum ve dedim ki, korku filmi izleme, metal müzik dinleme! Psikolojin bozuluyor. 	korku
Unnie seni kaç kere aradık! Çok endişelendim.	korku
Bir an ödüm koptu 10 sene sonra kendimi ağaçkakan gibi göreceğim diye. Çok şükür 22 değilmiş 	korku
Serra birden şiir okumaya başladı korktum	korku
telefonumu titreşime almıştım mertcanın bildirimlerinden sonra daha da almam korktum amk	korku
Bir kaç haftadır boş vakitlerimi evde uyuyarak geçirdiğimi defaatle fark edip irkildim.	korku
batuhanla spor yapıcaz korkuyorum tayt giydi	korku
Kuran çarpsın rüyamda ne gördüysem hepsi tıkır tıkır önüme geliyor bugün, ürktüm	korku
İzlerken çok korkak olduğumu farkettim.bakarken bile ürktüm :)	korku
Mısra aradı ağlıyor dedim niye ağlıyorsun çok korkmuş bir şey oldu diye bana bir şey olsa burada tivit mi atarım	korku
O kadar dişçiye geldim tedavi gördüm hala ilk günkü gibi çok korkuyorum	korku
Bulaşık yıkadım çok korkunçtu bir an ölücem sandım	korku
Geçtim karşısına tam patır patır her şeyi söylüyorum korktum yumuşamaktan	korku
Korktum o nasıl bir bağırıştı	korku
Böyle bir hışımla girdi menşına ben ürktüm	korku
İlk defa bi arkadaşım için endişelendim. gidiyorum buralardan diyip internetini kapadı..	korku
Kapılırsam sonu yok, herşeyi feda edeceğim, ürkütücü	korku
Tarkan, mimiklerinden çok korktum ya. Niye öyle oldu? 	korku
Kapalı alanda duramama fobim var çünkü sigara içiyorum	korku
Sen kork o zaman ben ölürsem hayalet olarak gelirim	korku
Arkadaş bir kabus gördüm, korku aksiyon dalında Oscar'lık.. Kafama çekiçle vurulmuş gibiyim 	korku
İçinizde öldürdüğünüz kişiyi karşınızda görmek çok korkutucu değil mi?	korku
30 mükemmel bir yaş olabilir lakin bana çok korkutucu geliyor	korku
Rüya mı gördüm kabus mu karar veremedim ama etkisinden çıkamıyorum 	korku
Kız şıllık bir sana bir de siyah kedilere fobim var uzak dur benden	korku
Gözleri keskin, gözleri keskin, gözleri keskin bir tren sesi kadar korkutucuydu..	korku
ABD, hala yasal olan bireysel silahlanma ve yine facia bu kez Texas'ta bir kilise, onlarca ölü, toplum olarak ödenen bedel.	korku
Temizlik şirketlerinin çoğalması endişe verici kimse evde temizlik yapmıyor mu? 	korku
Bunun gerçek olabilme ihtimali korkunç, eğer gerçekse çok daha korkunç 	korku
Ah vizeler kara vizeler kabus gibi çöken vizeler	korku
Herşey tamı tamına bir saniye sürdü. Önce şiddetli bir sarsıntı hemen arkasından ürkütücü bir patlama sesi. Sağa sola koşuşturan insanlar... 	korku
Otobüs tekerleği fobim var bugün fark ettim çok ilginç değil mi	korku
Gerçi onlarda ayrı manyak şimdi araştırınca ürktüm biraz	korku
Bu ne yahu kabus gibi bir gündü...	korku
Rüyamda ders çalışmak zorundaydım. Rüya değil kabus adeta.	korku
Fed/Evans, ABD'de enflasyon bekleyişlerindeki düşüş endişe verici	korku
nasıl yağmur yağıyor vallahi ama acayip gök gürlüyor korkuyorum 	korku
Dün neydi öyle ya, cavs kaybedecek diye ödüm koptu.	korku
Kedi yavrulamış ödüm koptu amk ama çok tatlılar	korku
Kerkük'te büyük facia: 20 ölü, 100 yaralı	korku
Pazar günlerinden hoşlanmam fakat bugün çok farklı geçti. Emeği geçen bütün arkadaşlarıma sevgilerimle :) Harika hissediyorum iyi ki varlar	mutlu
Mükemmel bir geceden sonra arkadaşlarımın isteği ile okula gitmeye karar verdim, harika hissediyorum ::))	mutlu
Staja gitmedim çok mutluyum.	mutlu
aşkım benim iyiki doğmuş canımın içi canımdan bir parça oy annesinin gülü iyiki var 	mutlu
hep sevmekten ziyade her gün farklı sebeplerden daha çok seviyorum.	mutlu
Hayat bugün eğlenceli şimdi çarşı zamanı kardeşimin tweettere atmak istediği tweetmiş 	mutlu
Harikaydı çok güldüm hatta yarıldım emeğinize sağlık	mutlu
Nasıl bir enerji varsa havada, kendimi harika hissediyorum, bir de bütün dileklerim gerçek olursa, tutmayın benii :) :)	mutlu
Arif ve 216yı izledim beğendim, snap atmadım, sevinçliyim, gururluyum	mutlu
Bugün benim doğum günüm ???? 21 de bitti 	mutlu
Dünyayı iyilik ve merhamet kurtaracak! 	mutlu
Ankaradayım :) İzmirden sonra ki memleketim olmuş burası ya, harika hissediyorum kendimi keyifliyim :))	mutlu
Yeni yıl sana yeni yıl bana yeni yıl bize kutlu olsun	mutlu
Peaky blinders’e başlıorum çok heyecanlıyım hadi hayırlı olsun	mutlu
Ve annesi o sarı saçlı mavi gözlü bebekle ilgilenmemi istedi. Çok mutluyum şu an... 	mutlu
Bütün gece harika hissediyorum dünyadaki en mutlu kişi benim, tam yatacağım modumu düşürüyorlar, mutlu uyuyamıyorum.	mutlu
russian roulette albümünü açınca oynamadan duramıyorum çok komik	mutlu
Ay bayağ güldüm buna Ethem Başkan ölüleri diriltebilir belki çok mantıklı bir yorum olmuş	mutlu
Her fotoğrafım ifşa niteliğinde çünkü tipim normalde de komik	mutlu
23 Nisan Ulusal Egemenlik ve Çocuk bayramımız kutlu olsun Ayrıca tüm müslüman aleminin Regaip Kandilini kutlarım 	mutlu
Yemek siparişini beklemek hiç bu kadar eğlenceli olmamıştı. 	mutlu
En son ne zaman bu kadar güldüm acaba 	mutlu
Birinin iyi derece soyut matematik eğitimi alabilmesi için neden iyi derecede türkçe biyoloji kimya bilgisi olması gerekli 	mutlu
Aybüke Pusat güzel dans etti vallahi gösterisini beğendim.	mutlu
Sevdiğim insanların da beni sevmesi harika bir duygu	mutlu
hemstırlar çok sevimliler çok seviyorum  	mutlu
Bende ki GALATASARAY sevgisi bir başka	mutlu
Oyuncak uçak aldım aşırı mutluyum şu an	mutlu
Gülşenin genç versiyonu mu diyorlar :) ilk defa duydum. epey komik.	mutlu
Ailesiyle güzel sohbetin ardından söylenen şarkılar türküler ile hepimiz harika anlar yaşıyoruz 	mutlu
Kendime onlara adayacağım içinde kaybolacağım kitaplar aldım, çok mutluyum	mutlu
Akdeniz üniversitesi'nde bir erkek doktora aşık oldum resmen	mutlu
Yine cin olmadan adam çarpmaya çalışanların mallıklarını izleyip eğlendim	mutlu
bu seneki festivaller efsane geçiyor her gün festival olsa da coşsak 	mutlu
Duman ve grup yorum şarkılarıyla ameliyat oldum local anestezide eğlenen tek insan benim herhalde :D 	mutlu
Dünyaya gözlerimi açtığım gün bugün, kendimi harika hissediyorum :) Günaydınlar	mutlu
Zafer bayramımız kutlu olsun 	mutlu
Şampiyon BEŞİKTAŞ'ım ne istersen iste benden ???? 	mutlu
Kulaklarının iyi duyduğu zamanlarda eğlenceli olabiliyor yada bizim eğlence anlayışımız çok farklı :)	mutlu
Feyza bir aşktır onu seviyoruz 	mutlu
Arkadaşlar harika hissediyorum buraya yazayım ki nazar değsin bünye alışık değil	mutlu
Bugün benim doğum günüm 21 de bitti 	mutlu
Yaşasın. Sevgililer gününde sevgilim var.	mutlu
haha cidden düşündüğüm gibiymiş işte buna daha cok güldüm ve tastikledim muhattabım olamazsın	mutlu
Mesleki gelişim 55 mi haha harika hissediyorum	mutlu
pizza ve waffle sevmediğimi söyleyince insanlar çok garip tepkiler veriyo yüz ifadeleri çok komik oluyor	mutlu
Son 2 yıldır hiç bu kadar mutlu olmamıştım. Teşekkür ederim Allah'ım	mutlu
Çok şık hareketler bunlar Eğlenceli bir haftasonu olacak Merakla bekliyoruz :))	mutlu
Sevginize, ilginize çok teşekkür ederim. Tam da şu an mutluyum paylaşasım var 	mutlu
Türk hakemleri gerçekten çok komik :)	mutlu
Bir türk kahvesi içiyim dönerim tekrar sohbet ederiz aşklar öptüm	mutlu
Twittera girdim eğlendim şimdi çıkıyorum	mutlu
Güzel bir spordan sonra simitimi yedim harika hissediyorum :))))	mutlu
Banyo etmek dünyanın en güzel şeyi, dünya varmış demek 	mutlu
Bence bu Ales etiketine yorum yazanlardan müthiş akademisyen olur. Çok güldüm :))	mutlu
küçük mutluluklar yaşamak benim işim 	mutlu
İnstagramdan tüm okullar açılıyor diye birşeyler paylaşan kişileri unfladım mutluyum.	mutlu
Fineas ve förb izliyordum kliplerinin top 10 listesini verdiler çok eğlendim çok mutluyum	mutlu
Son 2 yıldır kendimi emekli etmiştim konferanslardan Lakin 3 tane harika konferansta bulunacağım önümüzdeki 6 hafta içerisinde 	mutlu
Sınavdan sonra 113 tane not kağıdı resmini sildim galeriden Mutluyum	mutlu
Çok güldüm inşallah başıma gelmez	mutlu
Şu ruh haliyle okula koşturmayı, sınavlara girmeyi başarıyorum. Çünkü harikayım 	mutlu
big mouth izliyorum baya güzel beğendim gidip herkese övücem	mutlu
Ben onun o kıpkırmızı gözlerine aşık oldum.	mutlu
Arkadaşlarıma e okul fotoğrafımı atıyorum ve dalga geçiyoruz eğlenceli	mutlu
Geç kalmış doğum günü hediyemiz için teşekkür ederiz 	mutlu
Epey güldüm. Iraklı bir antropologun naif batı kültürü üzerine araştırmaları	mutlu
Beklemeye değdi bu yüz ifadesi çok güzeldi	mutlu
2017 oldu sevindiğimiz şeye bak amk elektriğin gelmesi 	mutlu
Tüm islam aleminin Ramazan Bayramını kutlarım 	mutlu
Bir müzik bütün modumu değiştirdi harika hissediyorum hayaller falan efsane. Herhangi bi şey bunu bozmadan neti kapatıp uyuyorum :D	mutlu
Tarkan'ın baba oluşuna çok sevindim. O nasıl bir haber veriştir. Her zaman çok tatlı. :)	mutlu
Son üç vize çok sevinçliyim; bekleyin beni canım dizilerim... 	mutlu
Ne taraftan baktığına bağlı bu taraftaki pencereden gayet hoş	mutlu
Boş zamanlarında ne yapıyosun diye sorsalar düşme videoları izleyerek eğleniyorum derim, bak yazarken bile eğlendim	mutlu
Neyse eğlendim yemek yapmaya gidiyorum	mutlu
Fenerbahçe forması giyer misin sorusuna şeref duyarım diyen taçsız kral doğum günün kutlu olsun	mutlu
Aslı'nın Ben hayatımda sadece aşık olduğum insanı öptüm deyip Ferhatla öpüşmesi kalp biz	mutlu
Yaşasın cuma yaşasın pijamalarım, panduflarım ve kitaplarım 	mutlu
Ya yemin ederim stalkların en güzeliydi çok güldüm çok eğlendim haha	mutlu
Prison Break 6. Sezon çıkıyormuş muazzam sevinçliyim şu an	mutlu
Yeğenimin oyuncaklarıyla eğlendim	mutlu
Sevgililer gününü seviyorum fakat sebebi sadece indirimler	mutlu
Hepinize sevgiler, saygılar, teşekkür ederim	mutlu
Bugün de eşimle gittim iyi ki gitmişim hem eğlendim hem güldüm 	mutlu
Dünün acısını çıkartarak her saatimi yemek yiyerek geçirdim harika hissediyorum	mutlu
Düğün, söz, nişan gibi etkinliklerde sakinleştirici etki ederek yer almayı seviyorum 	mutlu
ablam babam ben eğlendim geldim çok güldük ya hep böyle olsa	mutlu
Doğum günün kutlu olsun, mutlu ol senelerce	mutlu
Esmoş her türlü entrikaya rağmen güzeldi 	mutlu
bugün yanlış etikete bakıp 10 liraya kocaman parmesan buldum diye sevindim	mutlu
ya ben bugün çok fazla pozitif mutlu bir o kadar neşeliyim kendimi harika hissediyorum :D	mutlu
Bu gece aleynalarda kalıyorum çok mutluyum yaşasın çok eğleniyorum	mutlu
La case de papeli erkenden sorunsuz ve spoilersiz bitirdiğim için çok mutluyum Allahım	mutlu
kadıköy seni çok seviyorum ama kimse yürümeyi bilmiyor	mutlu
Sabah sabah Çok Güldüm Ellerine sağlık emeği geçenlerin 	mutlu
Alttan aldığım dersi geçtim taktir almış çocuk gibi sevinçliyim. Hadi internet kafeye gidip cs oynama vakti.	mutlu
Dünya Pizza Günü’nüz kutlu olsun!	mutlu
O kadar eğlendim ki, telefonun içinden alıp karşıma koymak istedim	mutlu
Rimelim çok güzel kıvırıyor ya kendimi harika hissediyorum şu an	mutlu
Sabah sabah yoga ve spor yaptım harika hissediyorum	mutlu
nceliksoydan mükemmel ikili olduğumuzdan aksiyon filmi tadında hayatımız ¦ iyi mi kötü mü bilemedim gerçi D 	mutlu
epey komik şeyler oluyor sıkı tutunun	mutlu
Etrafımda güzel insanlar olmasına bayılıyorum ya böyle başka bir boyut gibi geliyor sürekli keyifli hissediyorum lütfen çirkin insanlar üremesin	mutlu
Genelde doğru seçimler yapamayan birisiyim ama senin hayatımın en doğru kararıymış gibi duruşunu seviyorum	mutlu
Selim İleriye samimi mektubu ve nezaketi için teşekkür ederim 	mutlu
Sevgili kardeşler 23 Nisanınız kutlu olsun bugün benim doğum günüm İyi dileklerde bulunan tüm güzel arkadaşlarıma teşekkür ederim 	mutlu
Mirayı kız kardeşim olarak atadım öyle çok seviyorum	mutlu
Uludağ’a aşık oldum. Bence o da bana karşı boş değil	mutlu
Daha çok gül çok komik çok	mutlu
Kopyasız matematik sınavından 68 aldım kendimi Harika hissediyorum :3	mutlu
Az önce 7 tane halley yedim şu an harika hissediyorum :)	mutlu
Evet verenlerin ulusal egemenlik bayramını kutlaması lol 	mutlu
Sevindim herşey yolunda gider umarım 	mutlu
Az önce kendi kendime spoiler verdim ama mutluyum 	mutlu
Bunun montaj olduğu çıplak gözle anlaşılıyor. Kendi pisliğiniz bize tutmaz. Kendi pisliğinize solcuları alet etmeniz çok komik. :)	mutlu
Bu gece çok eğlendim gerisini önümüzdeki günlere bırakıyorum	mutlu
Kitap, kahve, polar üçlüsünü seviyorum	mutlu
Çok mutluyum çünki 6 aydır Hatay beni görmemişti	mutlu
Aşkım seni buğradan daha çok seviyorum bende seni öperim	mutlu
Gittiğim gençlik kampı inanılmaz güzeldi.Bütün liderlerimi seviyorum	mutlu
Sıyah beyaz aşk bu akşam kanal d de Çok seviyorum bu dizi	mutlu
Hesabın çok güzel icon bio hepsini beğendim	mutlu
Ya bu kısım inanılmaz güzeldi, Namjoon sana aşığım 	mutlu
İnanılmaz güzel bir sigara içiyorum şu an. Tam istediğim gibi mutluyum	mutlu
Bütün akrabalarımı stalkladımm çok eğlendim	mutlu
Altın kelebekte bir ilk ! İlk defa güzel başladı. vallahi beğendim 	mutlu
doğrusunu bildiğimiz yalanları dinlemek çok eğlenceli değil mi	mutlu
Değil 4 yıl çok uzun yıllar bu formayı giymek ve başarılar yaşamak nasip olur inşallah Allah'ım utandırmasın 	mutlu
Beni destekleyen herkese teşekkür ederim. Sıcaklıklarını hissediyorum. Bu kadar güzel yüreğe girmiş isem kaybetmiş sayılmam.	mutlu
Çevremdeki insanların beni eskisi kadar sevmediğini hissediyorum bu harika bir duygu	mutlu
Gülhan Şen gibi giyinen kızlar çok hoşuma gidiyor çok sevimli..	mutlu
2018 den ilk beklentim gerçekleşti ve istediğim oranda zam aldım bir miktar sevinçliyim :)	mutlu
Güneydoğu Tv de program sonrası. İlgi gösteren tüm izleyenlerime teşekkür ederim. 	mutlu
Bu güzel ve eğlenceli gece için teşekkürler :)	mutlu
Bak o daha güzel fantezi çok da eğlenceli olur ??	mutlu
Ben başaksehire gitmesine üzülmedim aksine bize gelmediği için çok sevinçliyim.	mutlu
Gülmeyi seviyordum, güldürene aşık oldum.. hamdolsun! nokta.	mutlu
Yalnız sınav efsaneydi ben baya baya eğlendim. O kadar eğlendim ki süre nasıl geçti anlamadım! 	mutlu
Yaşasın bugün dizim var!!	mutlu
Beni halı saha maçına çağırdılar yaşasın defansların efendisi vezirin geri dönüşü	mutlu
Coştuk bir kere tutabilene aşk olsun. 4 oldu	mutlu
Otobüste yolculuk yapsak kekimi sana veririm çünkü seni çok seviyorum	mutlu
Hep kardeş olacak değiliz ya, yaşasın halkların sevgililiği!	mutlu
Eğlenceli bir pazar etkinliği olarak hakkın rahmetine kavuşuyorum	mutlu
Ve ilk istifamı da vermiş bulunmaktayım, mutluyum, teşekkürler	mutlu
390knın arasında bende varım sevinçliyim, ilk hafta satışlarına ilk defa tiffanyden sonra girebildim 	mutlu
Twitter arkadaşımla reelde de konuştuk nihayet mutluyum :))	mutlu
Kurban bayramınız mübarek olsun Sevdiklerinizle birlikte nice mutlu sağlıklı bayramlara 	mutlu
Her şey çok güzel geldi bu hafta bence Haftaya da iyi izlenecek.	mutlu
Beni yormadan kendi davranışlarınla boş bir insan olduğunu gösterdiğin için teşekkür ederim	mutlu
İstanbul'a dönüş yapıyorum. İki gün boyunca Trabzon'da çok güldüm çok eğlendim.	mutlu
Millet, burayı gezmek cidden çok güzeldi. Legolarla oynamak çok eğlenceli.	mutlu
Çok mutluyum ya hayatımda ilk defa hukuktan 80 almışım	mutlu
Çok güzel gülüyorsun sevmemek elde değil.	mutlu
Günaydın harika hissediyorum son 2 gündür :)	mutlu
annemden iyi zeytinyağlı sarma yapan herhangi bir varlık olamaz bu evrende gece gece ne gömdüm 	mutlu
Bugün Robinimle sahilde bir güzel eğlendik	mutlu
Yağmur damlasıyla gelen erken çıkabilirsiniz maili sen benim canımsın seni seviyorum.	mutlu
haklısınız çok eğleniyoruz 	mutlu
Hayret ettim kalbime bazen..	surpriz
Bu kadar söven ilk defa oldu ama hakem nasıl duymuyor hayret ettim	surpriz
Piyangonun sana çıkmadığına çok şaşırdım hâlbuki bütün numaralar sendeydi.	surpriz
Hava bulutlu burda hayret ettik nasıl olur da bulutlu olur ??	surpriz
Tokat'lım da sürpriz yaptı	surpriz
8'de uyanıcam diye kendimi ayarlamıştım, resmen 8'de kalktım. Uykumu da almışım hayret ettim.	surpriz
Ya inanmıyorum. Hoseok canlı yayın yapıyor ve ben okula gidiyorum.	surpriz
Ben kendimle savaşırken senin kazanman bana da sürpriz oldu.	surpriz
Bu yavşaklıkla nasıl bu kadar adamlık taklidi yapabilmiş hala şaşkınım.	surpriz
Şok oldum gerçekten büyük bir şoka uğradım. Vallahi billahi inanasım gelmiyor. Bu kadar olur yani. 	surpriz
Milli takıma çağırılmak bana sürpriz oldu. Artık herkesin beni unuttuğunu sanıyordum. 	surpriz
Bitirmiş ya şaşkınlık verici gerçekten insan inanamıyor	surpriz
Burcu ile badegül diye dalga geçiyorduk erkek cıktı, adı da ardaymış ben şok cidden hiç anlamadım 	surpriz
Çocuklara sürpriz yapıp küçük ama güzel hediyeler almalıyım 	surpriz
Bugün hayat soldado nun hat-trick yapması kadar şaşırtıcı ama güzel.	surpriz
Kale anaokulu'ndaki tüm mesai arkadaşlarıma teşekkür ederim. Güzel bir sürpriz oldu... 	surpriz
Yalnız Pektemek kısa sürede iyi oynadı, şaşkınım	surpriz
Ya ya ben bile şoktayım senden bir sürpriz beklerdim	surpriz
Oha gerçekten dünyayı gezmeden önce kendi ülkemi mi gezeyim? Ciddi olamazsın ya bu orijinal fikrin hemen patentini al.	surpriz
Annem şok'tan yumuşatıcı almış ve la vie est belle kokuyor son zamanların en şaşırtıcı olayı	surpriz
Hayret bu şerefsizden bu kadar adil ve düzgün bir yorum son zamanlarin en şaşkınlık verici olaylarından	surpriz
GS kadın voleybol baya iyi oynuyor şaşkınlık verici	surpriz
Hayret niye görüştürülmüyorsa artık! Yeni farkedilen birşey olsa gerek	surpriz
PDR'nin eğitimdeki işlevine siz inanmazsanız kim inanacak. Şaşkınlık verici 	surpriz
Bu tiple okula girdiğine şaştım birde sekreter oha	surpriz
Yok artık inanmam ama olmaz olmaz deme	surpriz
Muavin bir şey içip içmediğimi sormak için beni uykumdan uyandırdı hala şaşkınım	surpriz
Ben de sana hayret ediyorum Anadolu cennet diyorum inanmıyorsun! 	surpriz
Aaa 6Snin yediği gol iptal mi edilmiş çok şaşırdım nasıl olur ya aaa inanamıyorum 	surpriz
Kararlarım bana da sürpriz oluyor	surpriz
Aaa komisere de replik yazmışlar. Ben şok	surpriz
Aaa sahnemiz varmış Şu an şok oldum 	surpriz
Bütün evlatlarım güncelleme yapıyor bugün nasıl bir kral şaştım kaldım vallahi 	surpriz
Fakat üst sınıflarından görmeye alışık olduğumuz dev ekranı A serisinde görmek sürpriz oldu.	surpriz
Bugün kendime bir sürpriz yaptım	surpriz
Çok güzel bir gün geçirdim. Çok güzel haberler aldım, sürpriz şeyler oldu. Hep böyle devam etsin Allah'ım ne olur	surpriz
Cem Korkmaz intihar etmesi neredeyse imkansız bir adam hayret ettim.	surpriz
Sürpriz yaptım diyorsun da ben bir şeylere şaşırmayı o Temmuz ayında bıraktım.	surpriz
Şu bet sesimi beğenen bir kaç insan var hayret ettim	surpriz
Aaa yatağımda hediye paketi var kim bana sürpriz yaptı ya	surpriz
Ne diyeceğimi, diyip demeyeceğimi şaşırdım.	surpriz
Aaa şoktayım, BEIN SPORTS 3 te, Fb ligin en diri takımı dediler, ne oldu bunlara.	surpriz
Hayret ettim kalbime bu kadar şeyi nasıl sineye çekti acaba	surpriz
Kadın dizisinde Sarp bilmecesinde çok şaşırtıcı bir iddia ortaya atıldı	surpriz
Vartoluda ki dövmeyi görünce şok oldum	surpriz
Oğlum bir çikolata kutusu keşfettim içinde tüm markalar var hangisini yiyeceğimi şaşırdım	surpriz
Ya insan insanı bu kadar hızlı nasıl satar şaşırdım :) 	surpriz
Gece tam bunu dedim inanmıyorum	surpriz
Uykuyu tutamadığım gecelerde dönüp de yazdıklarıma baktığımda bazen hayret ettim.	surpriz
Çocuk iki saattir hayvan gibi bakıyor sonra sevgilisi geldi sarıldı ben şok	surpriz
Oha ne izledim ben şu an nefes nerden alınıyordu	surpriz
asansör bozulmuş yine şaşırdım mı hayır	surpriz
O değilde ablam ilk defa twitlerimi beğendi hayret ettim	surpriz
Arkadaş son 12 saat içinde 9 tas aşure nedir ya kendime hayret ettim şu an	surpriz
Uykumuda almışım hayret ettim	surpriz
Babam ve halamlar geliyormuş sürpriz yapacaklarmış gerçekten sürpriz oldu ??	surpriz
Ay ben şok son 10 saatir şeyma storysin'de birşeyler paylaşmadı vallahi acayip merak içerisin'deyim hemen arayıp soruyorum 	surpriz
Bu kadar hızlı 'Tornistan' benim için bile sürpriz oldu	surpriz
sen mi yaptın yok artık inanmam hazır almışsındır :)))) ne bunlar	surpriz
Cem Yılmaz'dan bu denli mütevazı bir açıklama! Şaşırtıcı	surpriz
Aaa sürpriz son varmış	surpriz
Bugün yine on kişiden dokuzu seni sordu bana dondum kaldım 	surpriz
Ne güzel inandırdınız kendinizi kendi yalanınıza hayret ettik	surpriz
Vay çoktan Cumartesi’den yemeye başlamışız bile helal olsun akıyor resmen	surpriz
insan gerçekten hayret ediyor, yetmeli artık bu bekleyiş 	surpriz
Evdekiler ilkokul fotoğraflarımı çıkarmış Nilay çok değişmişsin diyolar oha ciddi olamazsın niye ki allah allah çok garip	surpriz
Hesap yaptım derbi maç sonucunu buldum... bende hayret ettim.	surpriz
Hayret bu sene 10 Kasım da kimse hasta olmadı	surpriz
Hadi yok artık OMG sabah sabah şok edici şeyler öğrenmek sınavım var benim bugün insaf	surpriz
Normalde uykum gelir ama uykum hala gelmedi şaşırtıcı	surpriz
kızın biri bot giymiş kollar göbek falan açık şaşkınlık verici bir durum	surpriz
Birden geldin aklıma yakıverdin ışıkları. Hayret ettim galiba mutluluktan... 	surpriz
Yeşil tavuk yumurtası… Hayret birşey ya	surpriz
Aaa konuşan göt yapmışlar. Ben şok 	surpriz
Oha yemek yemeye gittim geldim maç 2-2 olmuş	surpriz
Allah'ım 1 tlye oje aldım hala inanamıyorum ?? 	surpriz
Güzel bir sürpriz için uygun bir gün..	surpriz
Şaştım üç lisan biliyor okumuş çocuk borumu	surpriz
sen mi yaptım yok artık inanmam hazır almışsındır :)))) ne bunlar	surpriz
Bana inanman için ne yapmam lazım cidden bilmiyorum şaştım kaldım.	surpriz
Bu saatte yoğurt canı çekmiş ve almaya gitti hala şaşkınım	surpriz
Gerçekte çift olmasını istediğim hiçbir shipim yok. Oha.	surpriz
Ya inanamıyorum hadi onları engelledin benim gibi bir ponçiği nasıl engelledin	surpriz
İnsanların 4 yıldır sevgilisi var ya şoktayım	surpriz
Metroda bile çeken telefon evde çekmiyor. İnsan gerçekten hayret ediyor yani	surpriz
Merve yüzünden ilk defa evli birinin başkasıyla sevgili olmasını istedim tövbe kendime şaşırdım şu an..	surpriz
Sorgulamadan inanmama şaştım kaldım.	surpriz
Bunu 11 dakikada yaptığıma inanamıyorum ?? 	surpriz
Oha Akhisar Trabzon'a tersten plaka yazdırmış :d	surpriz
her seferinde bir öncekinden üst level şerefsizlikler ve daha fazla hayret	surpriz
M.E. Bakanlığının müfredatından ve oluşturduğu sistemden, pozitif beklentisi olan için icraatları şaşkınlık verici olabilir.	surpriz
Şu saatte pat diye kalktım. Sonra da şoka uğradım..	surpriz
Bu gece nedense enerjim yerinde neşem yerinde.Ben bile hayret ettim.	surpriz
Şaka falan değil di mi hala inanamıyorum da ben 	surpriz
Almanlar Türk olduğuma inanamıyor. Ben şok.	surpriz
Oha ya Esir bile aydere gitmiş inanmıyorum bilsem bende uçardım	surpriz
SK Hynix sürpriz yaptı, GDDR6 belleklerini piyasaya sürdü 	surpriz
Diyete başlayan ve yoğun ders çalışan ben kendime inanamıyorum şu sıra	surpriz
Daha şaşkınlık verici olanı; Sen bu duruma nasıl şaşırıyorsun Babako	surpriz
Az önce 3kg turşuyu 7 liraya aldım hala şaşkınım	surpriz
Şok oldum gerçekten büyük bir şoka uğradım. Vallahi billahi inanasım gelmiyor. Bu kadar olur yani.	surpriz
Ciddi olamazsın 3 kg balık mı yiyecek ??	surpriz
Anlatmaya çok ihtiyaç duyduğum şu olayları kimseye anlatmak istemeyişim de şaşırtıcı	surpriz
Hayret bugün demedi twwet efendi robot musun..	surpriz
Bitki çaylarından special birşey yaptım yengem bayıldı; ben şok	surpriz
Aldığım karara şaşıran insan görünce şey diyorum inan ben senden daha şaşkınım ya	surpriz
Şok eden polis yemini..! 	surpriz
Yükselen burcum akrepmiş şu an öğrendim şaşkınım	surpriz
Yazarken ben de hayret ettim kendime	surpriz
O değil de o cümleyi bağlaması benim için sürpriz oldu nedense :\ 	surpriz
Vay ne prim kasıyorsunuz tolga'dan ha	surpriz
Van depremi gibi sallantılar aynı düzlemde mi? Ne ara bu kadar yardım ayarlandı da gönderildi. Maşallah... hayret ettim bak.	surpriz
6 yaşından sonrası banada sürpriz oldu, oran 12.50	surpriz
Yok daha neler efendi adam ama uzun vadede asla olmaz.	surpriz
Kışın içilen çorbanın şaşırtıcı faydaları 	surpriz
Bende unutuyordum sonra tarihe bir baktım 17 kasım ben şok	surpriz
Serdar bir dur amk ya.. bir sakatlanma ya.. hayret birşey	surpriz
Az önce otobüs şoförü ortalar bomboş ama ilerlemiyorlar diyen yolcuya yok abi neresi boş dedi. Şoktayım	surpriz
Topalla stoper olmuyorsa neden isla'yı denemez bu hoca hayret birşey.	surpriz
Anneme sürpriz yapıyordum ki annem bana sürpriz yaptı....	surpriz
Oha türkçe destekleri bile var 	surpriz
Dondum kaldım resmen ne pozisyon kaçırdılar be	surpriz
Stalk çok şaşırtıcı bir olay eninde sonunda dönüp dolaşıp başladığım profilde buluyorum kendimi	surpriz
Yine aldığım kararlar en çok bana sürpriz oldu	surpriz
Zamanı gelmişti ama yine de Tesla Roadster konsepti büyük sürpriz oldu. 0-100 km/s: 2 sn! 	surpriz
Bu ödülü bize vermezler diyorum şaşırdım doğrusu 	surpriz
Az önce bi dolmuş şoförü yayaya yol verdi hayret ettim. Hayır normalde 50 cm bile bulsalar burunlarını sokuyorlar ya.	surpriz
Oha benimki öylesine bir umut da sen belki arkasından geçtin	surpriz
Evet anne siz şimdi beni salondan çıkardınız ya ben hiç anlamadım pasta getireceğinizi aaa sürpriz oldu pasta mı aldınız çok şaşırdım	surpriz
Aaa şu şey değilmi ya , sevmiyorum diyipte pişman olan ??	surpriz
Gitsem gidemem,kalsam kalamam. Şaştım bu işe diyen Çelik çaresizliği var üzerimde.	surpriz
Melek sandığım şeytanın maskesi düşünce şaşkına döndüm	surpriz
Diziyi izlemiyorum, bu videoyu görünce hayret ettim rahatsız oldum. Merakla soruyorum genel olarak böyle şiddetçi erkeği sunan bi dizi mi?	surpriz
Aaa sevgilim gelmiş. Konuş sevgilim 	surpriz
Ananem bana sürpriz yaptı geçen hafta aldığı çorabın grisini alarak 	surpriz
Oha evde pijamalarla çalışıyodum misafirler geldi pastayla doğum günü sürprizi yapmışlar şoka uğradım gidiyorum 12de iki tane pasta kescem	surpriz
Bizden olmazdı zaten, olur gibi olmasına hala şaşkınım ben	surpriz
şu oğuzhanı ilk onbirde inatla oynatan hocaya inanmıyorum artık.	surpriz
ne yazacağımı şaşırdım mk :) bildirime bak	surpriz
İlk defa bugün twitter donmuyor bende hayret 	surpriz
O değilde geçen akşam kınada peşimde dört dönen çocuk instagramdan beni bulup takip etmiş. Azme bakın hayret ettim ??	surpriz
Size şimdi hayret edici birşey söylücem çoğu şehre kara kış gelmişken biz burdur da hala kısa kollu giyiyoruz	surpriz
vallahi cok şaşkınlık verici ya şaşırdım :(	surpriz
Hayret gündemi değiştirecek bir şey çıkarmadılar daha.	surpriz
Ama galiba tüm bu olanlara dayanamam ama hazırım cümlesi gerçekleşti ben neye inanacağımı şaşırdım be.	surpriz
Annem bornozlarımızı ütülüyormuş şu an şoka uğradım	surpriz
Şaka yapıyorsun herhalde. Hangi mahkemede... .	surpriz
Faul var tabi konuşmaya değmez ama tetikçi cüneyt nasıl iptal etti şaşkınlık verici	surpriz
Kaynanam seviyor mu ne sürpriz yaptım hazırlığa denk geldim	surpriz
Biraz önce karpuzun sebze oldugunu öğrendim, hayretler içindeyim.	surpriz
O tamponu boyayan ustayı arayıp sorduğumda aaa sen farkettin mi diyor. nasıl farketmeyim tampon pembe araba bordo ?? 	surpriz
Allah uyuz versin de tırnak vermesin nasıl bir bedduadır ya şaştım kaldım	surpriz
Vay arkadaş hayata bakışım değişti. Ben şok ben iptal. Ben şey yapayım o zaman erzuruma geleyim bir ara.	surpriz
Bu kimya deneyi sonucunda, meydan çıkan görüntü çok şaşırtıcı... 	surpriz
Ali koçun konuşmasını nasıl veriyor fb tv hayret ettim	surpriz
Olmasan da oluyor. Şaşkınlık verici ama oluyor.	surpriz
Annem bana çay getirdi şu an şoktayım içsem mi içmesem mi bilemedim	surpriz
mucize eseri alarm falan çalmadan kalktım hala şoktayım	surpriz
İnsan hala bazı şeylere hayret ediyor	surpriz
>>>>>>> 6b3689b0209e3195e45b7b166d15112a10293fbe
Yüzünü göstermesine aşırı şaşkınım sehundan beklenmeyen hareketler	surpriz